"airport","year","month","domestic","international","total"
"ACY","2015","Jun","927","36","963"
"ACY","2015","May","964","16","980"
"ACY","2015","Sep","725","8","733"
"ACY","2015","Jul","992","39","1031"
"ACY","2015","Mar","907","3","910"
"ACY","2015","Nov","744","0","744"
"ACY","2015","Apr","901","3","904"
"ACY","2015","Oct","694","4","698"
"ACY","2015","Aug","922","41","963"
"ACY","2015","Feb","785","1","786"
"ACY","2015","Dec","759","1","760"
"ACY","2015","Jan","831","1","832"
"ACY","2014","Mar","871","4","875"
"ACY","2014","Jan","777","0","777"
"ACY","2014","Feb","738","2","740"
"ACY","2014","Jul","1038","4","1042"
"ACY","2014","Apr","965","4","969"
"ACY","2014","Dec","795","1","796"
"ACY","2014","Nov","963","0","963"
"ACY","2014","Aug","1077","4","1081"
"ACY","2014","Sep","845","5","850"
"ACY","2014","Oct","845","7","852"
"ACY","2014","May","1057","2","1059"
"ACY","2014","Jun","1047","7","1054"
"ACY","2013","Dec","728","2","730"
"ACY","2013","Feb","680","4","684"
"ACY","2013","Mar","789","2","791"
"ACY","2013","Jul","905","3","908"
"ACY","2013","May","928","3","931"
"ACY","2013","Jun","908","5","913"
"ACY","2013","Jan","716","2","718"
"ACY","2013","Oct","712","3","715"
"ACY","2013","Sep","746","2","748"
"ACY","2013","Aug","930","6","936"
"ACY","2013","Nov","796","2","798"
"ACY","2013","Apr","770","3","773"
"ACY","2012","Sep","834","2","836"
"ACY","2012","Dec","694","2","696"
"ACY","2012","Nov","718","2","720"
"ACY","2012","May","1051","4","1055"
"ACY","2012","Oct","749","2","751"
"ACY","2012","Mar","1005","4","1009"
"ACY","2012","Apr","977","2","979"
"ACY","2012","Feb","756","2","758"
"ACY","2012","Jul","1131","0","1131"
"ACY","2012","Aug","1118","2","1120"
"ACY","2012","Jan","808","0","808"
"ACY","2012","Jun","1065","1","1066"
"EWR","2015","May","26071","7582","33653"
"EWR","2015","Jun","26244","7645","33889"
"EWR","2015","Aug","27102","8322","35424"
"EWR","2015","Feb","21203","6386","27589"
"EWR","2015","Apr","26181","7884","34065"
"EWR","2015","Oct","27294","7180","34474"
"EWR","2015","Jan","23141","7027","30168"
"EWR","2015","Sep","25449","7091","32540"
"EWR","2015","Nov","26469","6880","33349"
"EWR","2015","Mar","25189","7652","32841"
"EWR","2015","Dec","26833","7734","34567"
"EWR","2015","Jul","27470","8436","35906"
"EWR","2014","Dec","25703","8024","33727"
"EWR","2014","Jun","25329","8031","33360"
"EWR","2014","Mar","25609","8021","33630"
"EWR","2014","Feb","19611","6192","25803"
"EWR","2014","Apr","22619","7502","30121"
"EWR","2014","Jul","26272","8966","35238"
"EWR","2014","Sep","24380","7107","31487"
"EWR","2014","Oct","25024","7329","32353"
"EWR","2014","Nov","25454","7106","32560"
"EWR","2014","Aug","26959","8438","35397"
"EWR","2014","May","22541","7991","30532"
"EWR","2014","Jan","22398","7049","29447"
"EWR","2013","Mar","25987","8111","34098"
"EWR","2013","Nov","25544","6949","32493"
"EWR","2013","Sep","25082","7263","32345"
"EWR","2013","Jul","26630","8399","35029"
"EWR","2013","Feb","22039","6997","29036"
"EWR","2013","May","26666","8039","34705"
"EWR","2013","Dec","25784","7100","32884"
"EWR","2013","Aug","27056","8299","35355"
"EWR","2013","Oct","26869","7546","34415"
"EWR","2013","Jun","25552","8025","33577"
"EWR","2013","Apr","26287","8116","34403"
"EWR","2013","Jan","24535","7846","32381"
"EWR","2012","Dec","23535","7521","31056"
"EWR","2012","Jul","26103","8793","34896"
"EWR","2012","Oct","23732","7215","30947"
"EWR","2012","Feb","23935","7531","31466"
"EWR","2012","Jun","26295","8337","34632"
"EWR","2012","Aug","29700","8671","38371"
"EWR","2012","Apr","26349","8302","34651"
"EWR","2012","Nov","24926","7087","32013"
"EWR","2012","Mar","26908","8436","35344"
"EWR","2012","Sep","24360","7613","31973"
"EWR","2012","May","26160","8218","34378"
"EWR","2012","Jan","24328","7949","32277"
"EWR","2011","Feb","20788","7165","27953"
"EWR","2011","Nov","25469","7538","33007"
"EWR","2011","Apr","25024","8519","33543"
"EWR","2011","Sep","24808","7728","32536"
"EWR","2011","Oct","25470","7777","33247"
"EWR","2011","Mar","26123","8687","34810"
"EWR","2011","Jun","26336","8519","34855"
"EWR","2011","May","25494","8347","33841"
"EWR","2011","Jan","22068","7882","29950"
"EWR","2011","Jul","26971","9229","36200"
"EWR","2011","Dec","26391","8143","34534"
"EWR","2011","Aug","25286","8410","33696"
"EWR","2010","Nov","24890","7597","32487"
"EWR","2010","Aug","28551","8985","37536"
"EWR","2010","Jul","25786","9125","34911"
"EWR","2010","Mar","25817","8256","34073"
"EWR","2010","Jun","25440","8420","33860"
"EWR","2010","Jan","24560","7832","32392"
"EWR","2010","Feb","20576","6579","27155"
"EWR","2010","Sep","23832","7553","31385"
"EWR","2010","Oct","27504","7962","35466"
"EWR","2010","Dec","23658","7512","31170"
"EWR","2010","Apr","25601","7892","33493"
"EWR","2010","May","25187","8151","33338"
"EWR","2009","Feb","23791","6848","30639"
"EWR","2009","Jun","25827","7833","33660"
"EWR","2009","Aug","26470","8623","35093"
"EWR","2009","Sep","24485","7119","31604"
"EWR","2009","Jan","25447","7410","32857"
"EWR","2009","Apr","26454","8178","34632"
"EWR","2009","May","26262","7884","34146"
"EWR","2009","Oct","25704","7209","32913"
"EWR","2009","Mar","26940","8098","35038"
"EWR","2009","Jul","26816","8547","35363"
"EWR","2009","Nov","24697","6970","31667"
"EWR","2009","Dec","24945","7372","32317"
"EWR","2008","Aug","28863","8694","37557"
"EWR","2008","Jan","26599","7399","33998"
"EWR","2008","Mar","27985","7894","35879"
"EWR","2008","Oct","28480","7429","35909"
"EWR","2008","Apr","28126","8343","36469"
"EWR","2008","Jul","29330","8576","37906"
"EWR","2008","Jun","27716","8087","35803"
"EWR","2008","May","27932","8425","36357"
"EWR","2008","Sep","25662","7461","33123"
"EWR","2008","Nov","26252","6802","33054"
"EWR","2008","Feb","24626","6975","31601"
"EWR","2008","Dec","26417","6854","33271"
"EWR","2007","Feb","25070","6291","31361"
"EWR","2007","Jan","28479","6686","35165"
"EWR","2007","Oct","28013","7507","35520"
"EWR","2007","Apr","28113","7301","35414"
"EWR","2007","Jun","27440","7707","35147"
"EWR","2007","Dec","26989","7237","34226"
"EWR","2007","Sep","26416","7465","33881"
"EWR","2007","Mar","28438","7016","35454"
"EWR","2007","Jul","27850","8292","36142"
"EWR","2007","Aug","29273","8479","37752"
"EWR","2007","Nov","27316","6930","34246"
"EWR","2007","May","29084","7498","36582"
"EWR","2006","Dec","29975","6755","36730"
"EWR","2006","Jan","27667","6161","33828"
"EWR","2006","Apr","29324","6679","36003"
"EWR","2006","Mar","31059","6829","37888"
"EWR","2006","Sep","27869","6845","34714"
"EWR","2006","May","29782","7136","36918"
"EWR","2006","Feb","25133","5668","30801"
"EWR","2006","Nov","28677","6273","34950"
"EWR","2006","Aug","30715","7913","38628"
"EWR","2006","Jul","29196","7862","37058"
"EWR","2006","Jun","28819","7342","36161"
"EWR","2006","Oct","29689","6927","36616"
"EWR","2005","Oct","29139","6258","35397"
"EWR","2005","Jul","29008","7575","36583"
"EWR","2005","Aug","30340","7278","37618"
"EWR","2005","May","29349","6304","35653"
"EWR","2005","Jun","28896","6694","35590"
"EWR","2005","Apr","28988","6172","35160"
"EWR","2005","Sep","27893","6327","34220"
"EWR","2005","Mar","30030","6216","36246"
"EWR","2005","Dec","30074","6151","36225"
"EWR","2005","Feb","25686","5475","31161"
"EWR","2005","Jan","26305","5908","32213"
"EWR","2005","Nov","28918","5571","34489"
"EWR","2004","Sep","27570","5887","33457"
"EWR","2004","Oct","30339","5945","36284"
"EWR","2004","Apr","29316","5997","35313"
"EWR","2004","Jul","29568","6764","36332"
"EWR","2004","Jan","27808","5541","33349"
"EWR","2004","Nov","29089","5540","34629"
"EWR","2004","May","28791","6048","34839"
"EWR","2004","Aug","30473","6874","37347"
"EWR","2004","Mar","29950","6016","35966"
"EWR","2004","Dec","29681","5811","35492"
"EWR","2004","Jun","29423","6172","35595"
"EWR","2004","Feb","27212","5318","32530"
"EWR","2003","Mar","27983","5701","33684"
"EWR","2003","Oct","29197","5558","34755"
"EWR","2003","Feb","22873","4681","27554"
"EWR","2003","Jan","26385","5366","31751"
"EWR","2003","Dec","27926","5272","33198"
"EWR","2003","Apr","26766","5272","32038"
"EWR","2003","Nov","27227","5026","32253"
"EWR","2003","Jul","28303","6167","34470"
"EWR","2003","Jun","27417","5830","33247"
"EWR","2003","Aug","27984","6164","34148"
"EWR","2003","Sep","25968","5504","31472"
"EWR","2003","May","27625","5419","33044"
"EWR","2002","Aug","28984","5741","34725"
"EWR","2002","Jan","26961","4854","31815"
"EWR","2002","Oct","28185","5076","33261"
"EWR","2002","Dec","26939","5114","32053"
"EWR","2002","May","27393","5671","33064"
"EWR","2002","Apr","27271","5158","32429"
"EWR","2002","Jul","28224","5876","34100"
"EWR","2002","Feb","24874","4519","29393"
"EWR","2002","Jun","26820","5670","32490"
"EWR","2002","Nov","26568","4666","31234"
"EWR","2002","Sep","26407","5170","31577"
"EWR","2002","Mar","27993","4973","32966"
"EWR","2001","Aug","33570","6333","39903"
"EWR","2001","Apr","32303","5011","37314"
"EWR","2001","Dec","25981","5025","31006"
"EWR","2001","Nov","26283","4447","30730"
"EWR","2001","Oct","27812","4734","32546"
"EWR","2001","Sep","23147","4746","27893"
"EWR","2001","Mar","31583","4924","36507"
"EWR","2001","May","32751","5293","38044"
"EWR","2001","Feb","29291","4218","33509"
"EWR","2001","Jun","31384","5489","36873"
"EWR","2001","Jan","31583","4883","36466"
"EWR","2001","Jul","32515","6296","38811"
"EWR","2000","May","30393","5238","35631"
"EWR","2000","Dec","29645","4732","34377"
"EWR","2000","Oct","31889","5040","36929"
"EWR","2000","Aug","31653","5672","37325"
"EWR","2000","Apr","30279","4851","35130"
"EWR","2000","Jul","30542","5671","36213"
"EWR","2000","Jun","29354","5287","34641"
"EWR","2000","Mar","32753","5055","37808"
"EWR","2000","Sep","30037","5329","35366"
"EWR","2000","Feb","29481","4504","33985"
"EWR","2000","Jan","28399","4642","33041"
"EWR","2000","Nov","30180","4798","34978"
"EWR","1999","Feb","28843","4080","32923"
"EWR","1999","Dec","32045","4500","36545"
"EWR","1999","May","31165","4901","36066"
"EWR","1999","Oct","32184","4837","37021"
"EWR","1999","Jul","32028","5238","37266"
"EWR","1999","Nov","30571","4497","35068"
"EWR","1999","Jun","31454","4939","36393"
"EWR","1999","Apr","31871","4748","36619"
"EWR","1999","Mar","32501","4654","37155"
"EWR","1999","Aug","33184","5368","38552"
"EWR","1999","Sep","30911","4798","35709"
"EWR","1999","Jan","28938","4447","33385"
"EWR","1998","May","32308","4697","37005"
"EWR","1998","Sep","30795","4275","35070"
"EWR","1998","Jan","30117","4020","34137"
"EWR","1998","Jun","30809","4351","35160"
"EWR","1998","Dec","32238","4385","36623"
"EWR","1998","Nov","30742","4219","34961"
"EWR","1998","Jul","33250","4855","38105"
"EWR","1998","Feb","28515","3771","32286"
"EWR","1998","Mar","32516","4366","36882"
"EWR","1998","Oct","32502","4556","37058"
"EWR","1998","Aug","32505","4886","37391"
"EWR","1998","Apr","32666","4473","37139"
"EWR","1997","Nov","30983","3917","34900"
"EWR","1997","Sep","32946","4102","37048"
"EWR","1997","Mar","33356","3361","36717"
"EWR","1997","Jun","32691","3952","36643"
"EWR","1997","Aug","34908","4414","39322"
"EWR","1997","Jul","34357","4443","38800"
"EWR","1997","Dec","32169","4008","36177"
"EWR","1997","Oct","33741","4161","37902"
"EWR","1997","Feb","31051","2905","33956"
"EWR","1997","Jan","33162","3163","36325"
"EWR","1997","May","32991","3769","36760"
"EWR","1997","Apr","33643","3445","37088"
"EWR","1996","Oct","35239","3236","38475"
"EWR","1996","Jan","26849","2623","29472"
"EWR","1996","Apr","32033","3058","35091"
"EWR","1996","Aug","36419","3750","40169"
"EWR","1996","Mar","30962","3003","33965"
"EWR","1996","Jun","33109","3298","36407"
"EWR","1996","Nov","32563","3021","35584"
"EWR","1996","Sep","33738","3317","37055"
"EWR","1996","Jul","34780","3657","38437"
"EWR","1996","Feb","28667","2668","31335"
"EWR","1996","May","33782","3120","36902"
"EWR","1996","Dec","33347","3219","36566"
"EWR","1995","Mar","30769","2675","33444"
"EWR","1995","Dec","29699","2731","32430"
"EWR","1995","Jun","30195","2823","33018"
"EWR","1995","May","29980","2593","32573"
"EWR","1995","Oct","31562","2660","34222"
"EWR","1995","Aug","32978","3127","36105"
"EWR","1995","Feb","28365","2307","30672"
"EWR","1995","Apr","29502","2590","32092"
"EWR","1995","Jan","30892","2427","33319"
"EWR","1995","Sep","30577","2777","33354"
"EWR","1995","Nov","29885","2484","32369"
"EWR","1995","Jul","31495","3121","34616"
"EWR","1994","Feb","26821","2363","29184"
"EWR","1994","Oct","32595","2531","35126"
"EWR","1994","Aug","33818","2792","36610"
"EWR","1994","Jun","32071","2720","34791"
"EWR","1994","Nov","32078","2311","34389"
"EWR","1994","Apr","32935","2635","35570"
"EWR","1994","May","33424","2548","35972"
"EWR","1994","Jul","32221","2865","35086"
"EWR","1994","Dec","32724","2389","35113"
"EWR","1994","Sep","31914","2534","34448"
"EWR","1994","Mar","32741","2794","35535"
"EWR","1994","Jan","29571","2591","32162"
"EWR","1993","Jun","32442","2507","34949"
"EWR","1993","Jul","34226","2639","36865"
"EWR","1993","Feb","27814","1945","29759"
"EWR","1993","Dec","34068","2650","36718"
"EWR","1993","Jan","31039","2285","33324"
"EWR","1993","May","32781","2233","35014"
"EWR","1993","Nov","32198","2612","34810"
"EWR","1993","Mar","29828","2117","31945"
"EWR","1993","Aug","34820","2747","37567"
"EWR","1993","Apr","31839","2353","34192"
"EWR","1993","Sep","32010","2615","34625"
"EWR","1993","Oct","33157","2692","35849"
"EWR","1992","Dec","30557","2171","32728"
"EWR","1992","Oct","31418","2309","33727"
"EWR","1992","May","30466","2229","32695"
"EWR","1992","Jul","30969","2630","33599"
"EWR","1992","Apr","29965","2079","32044"
"EWR","1992","Jun","30428","2414","32842"
"EWR","1992","Feb","27913","1872","29785"
"EWR","1992","Sep","30133","2338","32471"
"EWR","1992","Mar","30007","2086","32093"
"EWR","1992","Nov","29539","2272","31811"
"EWR","1992","Jan","28512","1925","30437"
"EWR","1992","Aug","30815","2604","33419"
"EWR","1991","Jan","27436","1852","29288"
"EWR","1991","Apr","26972","1635","28607"
"EWR","1991","Jun","27298","1819","29117"
"EWR","1991","Nov","27113","1816","28929"
"EWR","1991","May","27910","1774","29684"
"EWR","1991","Oct","28955","1908","30863"
"EWR","1991","Jul","28315","2111","30426"
"EWR","1991","Aug","29363","2059","31422"
"EWR","1991","Mar","27885","1694","29579"
"EWR","1991","Feb","24927","1637","26564"
"EWR","1991","Dec","28574","1801","30375"
"EWR","1991","Sep","27911","1981","29892"
"EWR","1990","Jun","27823","2172","29995"
"EWR","1990","Oct","28717","1885","30602"
"EWR","1990","Feb","24570","1258","25828"
"EWR","1990","Dec","27634","1765","29399"
"EWR","1990","Apr","27791","1813","29604"
"EWR","1990","Aug","29577","2322","31899"
"EWR","1990","Nov","28456","1804","30260"
"EWR","1990","Jan","26996","1478","28474"
"EWR","1990","Mar","28005","1589","29594"
"EWR","1990","Sep","27133","1967","29100"
"EWR","1990","May","28076","2056","30132"
"EWR","1990","Jul","28430","2390","30820"
"EWR","1989","Dec","26891","1416","28307"
"EWR","1989","Jan","27417","1088","28505"
"EWR","1989","Aug","28317","1659","29976"
"EWR","1989","May","26924","1349","28273"
"EWR","1989","Jul","27097","1681","28778"
"EWR","1989","Feb","24727","1032","25759"
"EWR","1989","Nov","27111","1340","28451"
"EWR","1989","Mar","26711","1104","27815"
"EWR","1989","Jun","25369","1544","26913"
"EWR","1989","Sep","26287","1422","27709"
"EWR","1989","Oct","28645","1374","30019"
"EWR","1989","Apr","25765","1149","26914"
"EWR","1988","Sep","28627","833","29460"
"EWR","1988","Apr","26206","800","27006"
"EWR","1988","Aug","28854","759","29613"
"EWR","1988","Nov","27116","897","28013"
"EWR","1988","Dec","29338","1011","30349"
"EWR","1988","Mar","27566","901","28467"
"EWR","1988","Feb","24808","830","25638"
"EWR","1988","Jan","25836","813","26649"
"EWR","1988","Jun","26898","866","27764"
"EWR","1988","Jul","27232","980","28212"
"EWR","1988","Oct","29404","925","30329"
"EWR","1988","May","26783","827","27610"
"EWR","1987","Dec","27741","342","28083"
"EWR","1987","Mar","28581","293","28874"
"EWR","1987","Sep","26435","373","26808"
"EWR","1987","Oct","27525","339","27864"
"EWR","1987","Jun","26995","281","27276"
"EWR","1987","Nov","26789","292","27081"
"EWR","1987","Aug","27360","436","27796"
"EWR","1987","Feb","25038","253","25291"
"EWR","1987","May","26865","299","27164"
"EWR","1987","Jan","27308","289","27597"
"EWR","1987","Apr","27282","306","27588"
"EWR","1987","Jul","27358","403","27761"
"EWR","1986","Nov","27456","331","27787"
"EWR","1986","Oct","30393","320","30713"
"EWR","1986","Aug","32296","442","32738"
"EWR","1986","Dec","28597","360","28957"
"EWR","1986","Mar","29700","350","30050"
"EWR","1986","Jan","28281","308","28589"
"EWR","1986","Feb","25491","271","25762"
"EWR","1986","Jun","30395","378","30773"
"EWR","1986","Apr","29680","337","30017"
"EWR","1986","Jul","31956","405","32361"
"EWR","1986","Sep","30267","333","30600"
"EWR","1986","May","30674","321","30995"
"EWR","1985","Feb","25153","223","25376"
"EWR","1985","Jan","27057","268","27325"
"EWR","1985","Mar","28494","274","28768"
"EWR","1985","Nov","27459","322","27781"
"EWR","1985","Oct","29431","362","29793"
"EWR","1985","Sep","26850","368","27218"
"EWR","1985","May","28651","320","28971"
"EWR","1985","Jul","29074","416","29490"
"EWR","1985","Dec","28502","328","28830"
"EWR","1985","Aug","30253","417","30670"
"EWR","1985","Apr","28104","305","28409"
"EWR","1985","Jun","27776","343","28119"
"EWR","1984","Jun","24782","272","25054"
"EWR","1984","Dec","26490","279","26769"
"EWR","1984","Feb","21706","191","21897"
"EWR","1984","Mar","23300","232","23532"
"EWR","1984","Aug","26425","379","26804"
"EWR","1984","May","24498","246","24744"
"EWR","1984","Jul","25756","391","26147"
"EWR","1984","Nov","25614","255","25869"
"EWR","1984","Oct","27015","302","27317"
"EWR","1984","Sep","25383","329","25712"
"EWR","1984","Jan","21921","178","22099"
"EWR","1984","Apr","23344","242","23586"
"EWR","1983","Mar","16116","222","16338"
"EWR","1983","Oct","21743","174","21917"
"EWR","1983","Jun","18856","248","19104"
"EWR","1983","Jul","19849","294","20143"
"EWR","1983","Jan","14750","156","14906"
"EWR","1983","May","16753","214","16967"
"EWR","1983","Feb","13017","173","13190"
"EWR","1983","Aug","20632","275","20907"
"EWR","1983","Apr","15776","231","16007"
"EWR","1983","Nov","21267","180","21447"
"EWR","1983","Sep","20422","238","20660"
"EWR","1983","Dec","22089","170","22259"
"EWR","1982","Mar","12940","163","13103"
"EWR","1982","Nov","13567","161","13728"
"EWR","1982","Feb","11502","142","11644"
"EWR","1982","Dec","14892","173","15065"
"EWR","1982","Jun","12816","290","13106"
"EWR","1982","Jul","12906","292","13198"
"EWR","1982","Sep","12945","183","13128"
"EWR","1982","Apr","12347","198","12545"
"EWR","1982","Jan","12226","163","12389"
"EWR","1982","May","12643","235","12878"
"EWR","1982","Aug","13496","292","13788"
"EWR","1982","Oct","13372","155","13527"
"EWR","1981","Dec","12791","111","12902"
"EWR","1981","Jun","14319","150","14469"
"EWR","1981","May","13879","123","14002"
"EWR","1981","Jan","12896","72","12968"
"EWR","1981","Apr","12874","116","12990"
"EWR","1981","Jul","15167","187","15354"
"EWR","1981","Oct","14036","118","14154"
"EWR","1981","Sep","13203","145","13348"
"EWR","1981","Mar","13360","94","13454"
"EWR","1981","Aug","12888","182","13070"
"EWR","1981","Feb","11829","52","11881"
"EWR","1981","Nov","13442","91","13533"
"EWR","1980","Apr","13069","185","13254"
"EWR","1980","Jun","12820","168","12988"
"EWR","1980","Aug","13175","140","13315"
"EWR","1980","Jan","13451","136","13587"
"EWR","1980","Sep","12640","124","12764"
"EWR","1980","Nov","12233","116","12349"
"EWR","1980","Feb","12128","127","12255"
"EWR","1980","Jul","13702","152","13854"
"EWR","1980","Mar","13157","160","13317"
"EWR","1980","May","13112","193","13305"
"EWR","1980","Dec","12588","68","12656"
"EWR","1980","Oct","13250","128","13378"
"EWR","1979","Apr","11619","398","12017"
"EWR","1979","Dec","12945","163","13108"
"EWR","1979","Jul","13354","298","13652"
"EWR","1979","Feb","11395","201","11596"
"EWR","1979","Jan","12810","233","13043"
"EWR","1979","Nov","13049","162","13211"
"EWR","1979","Sep","12924","277","13201"
"EWR","1979","Aug","13844","304","14148"
"EWR","1979","May","12176","420","12596"
"EWR","1979","Mar","13188","255","13443"
"EWR","1979","Jun","12768","283","13051"
"EWR","1979","Oct","13957","277","14234"
"EWR","1978","May","12173","333","12506"
"EWR","1978","Aug","13117","331","13448"
"EWR","1978","Apr","12076","263","12339"
"EWR","1978","Feb","10379","145","10524"
"EWR","1978","Mar","12757","237","12994"
"EWR","1978","Nov","12456","195","12651"
"EWR","1978","Oct","13118","265","13383"
"EWR","1978","Sep","12524","302","12826"
"EWR","1978","Jan","11075","148","11223"
"EWR","1978","Jun","12153","315","12468"
"EWR","1978","Jul","12322","336","12658"
"EWR","1978","Dec","13021","216","13237"
"EWR","1977","Jun","11073","253","11326"
"EWR","1977","Mar","11117","230","11347"
"EWR","1977","Feb","9914","176","10090"
"EWR","1977","Jan","10471","185","10656"
"EWR","1977","Apr","10847","313","11160"
"EWR","1977","Oct","11692","207","11899"
"EWR","1977","Dec","11563","190","11753"
"EWR","1977","Aug","11635","264","11899"
"EWR","1977","Jul","11464","270","11734"
"EWR","1977","Nov","10926","210","11136"
"EWR","1977","Sep","11120","235","11355"
"EWR","1977","May","10811","255","11066"
"JFK","2015","Jan","18777","13135","31912"
"JFK","2015","Apr","21055","14203","35258"
"JFK","2015","Nov","20253","13202","33455"
"JFK","2015","Oct","22111","14175","36286"
"JFK","2015","Aug","23323","17086","40409"
"JFK","2015","Mar","20189","13523","33712"
"JFK","2015","Sep","21119","14509","35628"
"JFK","2015","Dec","21740","14702","36442"
"JFK","2015","Jun","21936","15607","37543"
"JFK","2015","Jul","23006","17077","40083"
"JFK","2015","Feb","17510","11652","29162"
"JFK","2015","May","22016","14855","36871"
"JFK","2014","Dec","20601","14140","34741"
"JFK","2014","Jan","17193","12599","29792"
"JFK","2014","Apr","20041","13568","33609"
"JFK","2014","May","21597","14355","35952"
"JFK","2014","Jul","22427","16349","38776"
"JFK","2014","Mar","19924","13236","33160"
"JFK","2014","Aug","23200","16677","39877"
"JFK","2014","Sep","20651","14011","34662"
"JFK","2014","Jun","21846","15137","36983"
"JFK","2014","Oct","20935","13852","34787"
"JFK","2014","Feb","16225","11236","27461"
"JFK","2014","Nov","19389","13176","32565"
"JFK","2013","Dec","19542","13541","33083"
"JFK","2013","Sep","19453","13070","32523"
"JFK","2013","Feb","16987","10772","27759"
"JFK","2013","Aug","21921","15446","37367"
"JFK","2013","Apr","19376","12423","31799"
"JFK","2013","May","20228","13013","33241"
"JFK","2013","Jul","21695","15359","37054"
"JFK","2013","Nov","19013","12331","31344"
"JFK","2013","Jan","19290","12139","31429"
"JFK","2013","Mar","20176","12746","32922"
"JFK","2013","Jun","20317","13769","34086"
"JFK","2013","Oct","20135","13049","33184"
"JFK","2012","Dec","20063","12751","32814"
"JFK","2012","Sep","19760","13007","32767"
"JFK","2012","Nov","18802","11830","30632"
"JFK","2012","May","20105","12528","32633"
"JFK","2012","Jul","21348","14718","36066"
"JFK","2012","Aug","21285","14651","35936"
"JFK","2012","Mar","21143","12344","33487"
"JFK","2012","Apr","19935","12129","32064"
"JFK","2012","Jun","20668","13341","34009"
"JFK","2012","Feb","18886","10810","29696"
"JFK","2012","Jan","19507","11587","31094"
"JFK","2012","Oct","18249","11524","29773"
"JFK","2011","Aug","21083","13586","34669"
"JFK","2011","Jul","23061","14604","37665"
"JFK","2011","Apr","21056","12198","33254"
"JFK","2011","Nov","20046","11396","31442"
"JFK","2011","Jun","21747","13154","34901"
"JFK","2011","May","22166","12477","34643"
"JFK","2011","Dec","20241","12237","32478"
"JFK","2011","Mar","21683","12567","34250"
"JFK","2011","Sep","20929","12432","33361"
"JFK","2011","Oct","21090","12188","33278"
"JFK","2011","Feb","17940","10506","28446"
"JFK","2011","Jan","18979","11567","30546"
"JFK","2010","Dec","19702","11664","31366"
"JFK","2010","Oct","20689","11938","32627"
"JFK","2010","Feb","17495","10106","27601"
"JFK","2010","Jul","21825","14188","36013"
"JFK","2010","Jun","20296","12890","33186"
"JFK","2010","Aug","21955","13987","35942"
"JFK","2010","Sep","20113","11967","32080"
"JFK","2010","May","19999","12245","32244"
"JFK","2010","Jan","20283","11434","31717"
"JFK","2010","Apr","20120","10763","30883"
"JFK","2010","Mar","20459","11476","31935"
"JFK","2010","Nov","20500","11338","31838"
"JFK","2009","May","23604","12467","36071"
"JFK","2009","Mar","22840","11600","34440"
"JFK","2009","Sep","20357","11614","31971"
"JFK","2009","Jul","23820","13381","37201"
"JFK","2009","Feb","20426","10293","30719"
"JFK","2009","Aug","23894","13400","37294"
"JFK","2009","Oct","20658","11416","32074"
"JFK","2009","Jun","23155","12335","35490"
"JFK","2009","Dec","20863","11547","32410"
"JFK","2009","Apr","22261","11296","33557"
"JFK","2009","Jan","22152","11687","33839"
"JFK","2009","Nov","20145","10915","31060"
"JFK","2008","Apr","23491","12095","35586"
"JFK","2008","Jun","23388","12933","36321"
"JFK","2008","Feb","21447","11140","32587"
"JFK","2008","Oct","23110","12031","35141"
"JFK","2008","Jan","22860","11997","34857"
"JFK","2008","Aug","24300","14184","38484"
"JFK","2008","Dec","22697","12101","34798"
"JFK","2008","May","23488","12622","36110"
"JFK","2008","Mar","23760","12392","36152"
"JFK","2008","Nov","22210","11377","33587"
"JFK","2008","Jul","24553","14244","38797"
"JFK","2008","Sep","22421","12045","34466"
"JFK","2007","Mar","24809","11100","35909"
"JFK","2007","Jan","24181","10922","35103"
"JFK","2007","Jun","24097","12150","36247"
"JFK","2007","Feb","20309","9630","29939"
"JFK","2007","Apr","24441","11163","35604"
"JFK","2007","May","25155","11708","36863"
"JFK","2007","Dec","24173","11975","36148"
"JFK","2007","Aug","25815","13187","39002"
"JFK","2007","Sep","24513","11868","36381"
"JFK","2007","Nov","24343","11236","35579"
"JFK","2007","Jul","25129","13110","38239"
"JFK","2007","Oct","24941","11547","36488"
"JFK","2006","Jan","17501","9629","27130"
"JFK","2006","Dec","24099","11088","35187"
"JFK","2006","Jul","20315","11940","32255"
"JFK","2006","Jun","18341","11101","29442"
"JFK","2006","Nov","23192","10174","33366"
"JFK","2006","Sep","21445","10940","32385"
"JFK","2006","Mar","18419","10111","28530"
"JFK","2006","Oct","23416","10767","34183"
"JFK","2006","Apr","18235","9956","28191"
"JFK","2006","May","17918","10535","28453"
"JFK","2006","Aug","21151","11965","33116"
"JFK","2006","Feb","15478","8538","24016"
"JFK","2005","Dec","18034","9807","27841"
"JFK","2005","May","18659","9867","28526"
"JFK","2005","Oct","18573","9846","28419"
"JFK","2005","Feb","15941","8551","24492"
"JFK","2005","Jul","19396","11106","30502"
"JFK","2005","Aug","19843","10982","30825"
"JFK","2005","Jun","18496","10058","28554"
"JFK","2005","Apr","18079","9495","27574"
"JFK","2005","Jan","16531","9652","26183"
"JFK","2005","Mar","18222","9738","27960"
"JFK","2005","Sep","18065","9990","28055"
"JFK","2005","Nov","18725","9289","28014"
"JFK","2004","Sep","16436","9736","26172"
"JFK","2004","Jun","15954","9745","25699"
"JFK","2004","Jan","14371","8609","22980"
"JFK","2004","Nov","16766","9264","26030"
"JFK","2004","Aug","18326","11208","29534"
"JFK","2004","Mar","15150","8676","23826"
"JFK","2004","Feb","13972","8068","22040"
"JFK","2004","Apr","15497","9009","24506"
"JFK","2004","Dec","17105","10296","27401"
"JFK","2004","Jul","17290","11174","28464"
"JFK","2004","Oct","17643","9500","27143"
"JFK","2004","May","15602","9065","24667"
"JFK","2003","Jul","13621","10047","23668"
"JFK","2003","Dec","14657","8595","23252"
"JFK","2003","May","12867","8142","21009"
"JFK","2003","Sep","13052","8930","21982"
"JFK","2003","Jan","14303","9045","23348"
"JFK","2003","Nov","13518","8283","21801"
"JFK","2003","Feb","12261","7698","19959"
"JFK","2003","Apr","14152","7835","21987"
"JFK","2003","Oct","13922","8853","22775"
"JFK","2003","Aug","13327","10015","23342"
"JFK","2003","Mar","14721","8851","23572"
"JFK","2003","Jun","12768","8932","21700"
"JFK","2002","May","13893","8650","22543"
"JFK","2002","Jan","12394","8014","20408"
"JFK","2002","Apr","13774","8314","22088"
"JFK","2002","Sep","14519","9040","23559"
"JFK","2002","Mar","13652","8349","22001"
"JFK","2002","Feb","11688","7346","19034"
"JFK","2002","Nov","14102","8805","22907"
"JFK","2002","Aug","15593","10156","25749"
"JFK","2002","Jul","15198","9995","25193"
"JFK","2002","Dec","14463","9319","23782"
"JFK","2002","Jun","14144","9058","23202"
"JFK","2002","Oct","15062","9087","24149"
"JFK","2001","Mar","14708","9670","24378"
"JFK","2001","Feb","13047","8724","21771"
"JFK","2001","May","16731","9947","26678"
"JFK","2001","Aug","16287","11342","27629"
"JFK","2001","Apr","14975","9776","24751"
"JFK","2001","Jun","16271","9826","26097"
"JFK","2001","Oct","12166","8353","20519"
"JFK","2001","Jul","16169","11168","27337"
"JFK","2001","Jan","15015","9447","24462"
"JFK","2001","Dec","11362","8328","19690"
"JFK","2001","Nov","10932","7725","18657"
"JFK","2001","Sep","11583","8137","19720"
"JFK","2000","Apr","16206","10109","26315"
"JFK","2000","Sep","18162","10306","28468"
"JFK","2000","Jul","17869","11536","29405"
"JFK","2000","Nov","17358","9965","27323"
"JFK","2000","Jun","16991","10657","27648"
"JFK","2000","Mar","17174","10182","27356"
"JFK","2000","Oct","18880","10455","29335"
"JFK","2000","Feb","15559","9135","24694"
"JFK","2000","Jan","15554","9689","25243"
"JFK","2000","Dec","15279","10073","25352"
"JFK","2000","May","17293","10463","27756"
"JFK","2000","Aug","18579","11333","29912"
"JFK","1999","May","17428","9775","27203"
"JFK","1999","Jul","18249","11594","29843"
"JFK","1999","Dec","16799","9984","26783"
"JFK","1999","Nov","16532","9779","26311"
"JFK","1999","Jan","15313","9453","24766"
"JFK","1999","Sep","16796","10236","27032"
"JFK","1999","Feb","14893","8132","23025"
"JFK","1999","Apr","16843","9244","26087"
"JFK","1999","Oct","17860","10403","28263"
"JFK","1999","Jun","17888","10241","28129"
"JFK","1999","Aug","18123","11449","29572"
"JFK","1999","Mar","17156","9448","26604"
"JFK","1998","May","17357","10240","27597"
"JFK","1998","Mar","17597","9617","27214"
"JFK","1998","Apr","16693","9674","26367"
"JFK","1998","Jul","17826","11265","29091"
"JFK","1998","Sep","16785","10080","26865"
"JFK","1998","Feb","16759","8650","25409"
"JFK","1998","Aug","17547","11296","28843"
"JFK","1998","Oct","16707","9971","26678"
"JFK","1998","Dec","16847","9728","26575"
"JFK","1998","Jun","16266","10278","26544"
"JFK","1998","Jan","18206","9656","27862"
"JFK","1998","Nov","16433","9048","25481"
"JFK","1997","Mar","17723","9030","26753"
"JFK","1997","Nov","17416","9657","27073"
"JFK","1997","Sep","17662","10233","27895"
"JFK","1997","Jan","17304","9095","26399"
"JFK","1997","Jun","18084","10304","28388"
"JFK","1997","Feb","15859","8011","23870"
"JFK","1997","Dec","18476","9800","28276"
"JFK","1997","May","17904","9830","27734"
"JFK","1997","Jul","19265","11056","30321"
"JFK","1997","Aug","19051","11174","30225"
"JFK","1997","Apr","17175","9248","26423"
"JFK","1997","Oct","19000","9995","28995"
"JFK","1996","Dec","17926","9418","27344"
"JFK","1996","Jan","15222","9122","24344"
"JFK","1996","Feb","15489","8907","24396"
"JFK","1996","Jun","18885","10161","29046"
"JFK","1996","Apr","16686","9630","26316"
"JFK","1996","Jul","20081","11087","31168"
"JFK","1996","Nov","17955","8928","26883"
"JFK","1996","Sep","19070","10104","29174"
"JFK","1996","Oct","19451","9730","29181"
"JFK","1996","Aug","20707","11227","31934"
"JFK","1996","May","17978","9778","27756"
"JFK","1996","Mar","17006","9845","26851"
"JFK","1995","Oct","18424","9746","28170"
"JFK","1995","Apr","16734","9003","25737"
"JFK","1995","Jun","17430","9784","27214"
"JFK","1995","Sep","17687","9940","27627"
"JFK","1995","Jul","18289","11142","29431"
"JFK","1995","May","17583","9002","26585"
"JFK","1995","Aug","18876","11253","30129"
"JFK","1995","Feb","14165","7800","21965"
"JFK","1995","Mar","17103","8912","26015"
"JFK","1995","Dec","16117","9627","25744"
"JFK","1995","Nov","16505","9105","25610"
"JFK","1995","Jan","15722","8656","24378"
"JFK","1994","Apr","18271","8326","26597"
"JFK","1994","Dec","15572","8813","24385"
"JFK","1994","Aug","20915","10067","30982"
"JFK","1994","Mar","17808","8241","26049"
"JFK","1994","Oct","17954","8884","26838"
"JFK","1994","Feb","14717","6843","21560"
"JFK","1994","Jun","20658","9163","29821"
"JFK","1994","Nov","17058","8255","25313"
"JFK","1994","Sep","18675","9078","27753"
"JFK","1994","Jan","15764","8162","23926"
"JFK","1994","Jul","20916","10110","31026"
"JFK","1994","May","19741","8572","28313"
"JFK","1993","Sep","17451","8784","26235"
"JFK","1993","May","18001","8639","26640"
"JFK","1993","Jan","17541","8311","25852"
"JFK","1993","Aug","18966","9726","28692"
"JFK","1993","Dec","17199","8316","25515"
"JFK","1993","Feb","15258","7283","22541"
"JFK","1993","Oct","17356","9034","26390"
"JFK","1993","Apr","17326","8148","25474"
"JFK","1993","Jul","18831","9751","28582"
"JFK","1993","Jun","18094","8820","26914"
"JFK","1993","Nov","16792","7885","24677"
"JFK","1993","Mar","16513","7879","24392"
"JFK","1992","May","16673","8260","24933"
"JFK","1992","Apr","15829","7756","23585"
"JFK","1992","Oct","18003","8515","26518"
"JFK","1992","Jan","13807","7307","21114"
"JFK","1992","Jul","18347","9738","28085"
"JFK","1992","Sep","17539","8908","26447"
"JFK","1992","Jun","18041","8668","26709"
"JFK","1992","Dec","17345","8227","25572"
"JFK","1992","Mar","15255","7671","22926"
"JFK","1992","Aug","19028","9830","28858"
"JFK","1992","Feb","13431","6981","20412"
"JFK","1992","Nov","17283","7712","24995"
"JFK","1991","May","11745","7592","19337"
"JFK","1991","Dec","13564","7471","21035"
"JFK","1991","Jul","12290","9274","21564"
"JFK","1991","Jan","11031","7615","18646"
"JFK","1991","Mar","10971","6991","17962"
"JFK","1991","Sep","11126","8282","19408"
"JFK","1991","Nov","10441","7620","18061"
"JFK","1991","Jun","11737","8186","19923"
"JFK","1991","Oct","11283","8039","19322"
"JFK","1991","Apr","11269","6836","18105"
"JFK","1991","Feb","9821","5956","15777"
"JFK","1991","Aug","12573","9420","21993"
"JFK","1990","Nov","11131","7332","18463"
"JFK","1990","Dec","11234","7860","19094"
"JFK","1990","Sep","12195","8813","21008"
"JFK","1990","May","12103","8269","20372"
"JFK","1990","Jul","12875","9460","22335"
"JFK","1990","Mar","12669","8101","20770"
"JFK","1990","Aug","13184","9558","22742"
"JFK","1990","Jan","11953","7945","19898"
"JFK","1990","Jun","12224","8740","20964"
"JFK","1990","Oct","12198","8215","20413"
"JFK","1990","Apr","11918","7832","19750"
"JFK","1990","Feb","11155","7189","18344"
"JFK","1989","Jan","11653","7814","19467"
"JFK","1989","Nov","11696","7539","19235"
"JFK","1989","Dec","12081","7927","20008"
"JFK","1989","May","11473","8330","19803"
"JFK","1989","Feb","10607","6927","17534"
"JFK","1989","Aug","12747","9279","22026"
"JFK","1989","Jul","11934","9530","21464"
"JFK","1989","Sep","12186","8680","20866"
"JFK","1989","Mar","11435","7895","19330"
"JFK","1989","Oct","12172","8249","20421"
"JFK","1989","Jun","10935","8773","19708"
"JFK","1989","Apr","11211","7922","19133"
"JFK","1988","Jul","15163","9597","24760"
"JFK","1988","Jun","14824","8570","23394"
"JFK","1988","Aug","12427","9446","21873"
"JFK","1988","Mar","13782","7437","21219"
"JFK","1988","Jan","13616","7360","20976"
"JFK","1988","Sep","11411","8599","20010"
"JFK","1988","Feb","12844","6875","19719"
"JFK","1988","Dec","11637","7891","19528"
"JFK","1988","May","14335","7991","22326"
"JFK","1988","Apr","13775","7515","21290"
"JFK","1988","Oct","11553","8197","19750"
"JFK","1988","Nov","11082","7411","18493"
"JFK","1987","Sep","13810","7666","21476"
"JFK","1987","Feb","11633","5766","17399"
"JFK","1987","Oct","13833","7307","21140"
"JFK","1987","Apr","12323","6577","18900"
"JFK","1987","Nov","12761","6778","19539"
"JFK","1987","Jun","13438","7816","21254"
"JFK","1987","Mar","12778","6481","19259"
"JFK","1987","Dec","13814","7227","21041"
"JFK","1987","Aug","14756","8609","23365"
"JFK","1987","Jul","14333","8692","23025"
"JFK","1987","May","13053","7479","20532"
"JFK","1987","Jan","12234","6465","18699"
"JFK","1986","Feb","12272","5681","17953"
"JFK","1986","Sep","12530","7230","19760"
"JFK","1986","Dec","12885","6564","19449"
"JFK","1986","Jan","13675","6490","20165"
"JFK","1986","Jul","13178","7803","20981"
"JFK","1986","May","12553","7031","19584"
"JFK","1986","Nov","11898","6375","18273"
"JFK","1986","Apr","13153","6485","19638"
"JFK","1986","Aug","13889","7949","21838"
"JFK","1986","Mar","13484","6502","19986"
"JFK","1986","Jun","12796","7099","19895"
"JFK","1986","Oct","12724","6928","19652"
"JFK","1985","Aug","15257","8230","23487"
"JFK","1985","May","14699","7339","22038"
"JFK","1985","Oct","14653","6947","21600"
"JFK","1985","Sep","13722","7266","20988"
"JFK","1985","Jul","15262","8277","23539"
"JFK","1985","Feb","12432","5477","17909"
"JFK","1985","Dec","13844","6628","20472"
"JFK","1985","Apr","12917","6257","19174"
"JFK","1985","Jun","14359","7737","22096"
"JFK","1985","Mar","11950","6023","17973"
"JFK","1985","Jan","13993","6070","20063"
"JFK","1985","Nov","13194","6219","19413"
"JFK","1984","Nov","14301","6039","20340"
"JFK","1984","Jun","16020","7212","23232"
"JFK","1984","Aug","17173","7876","25049"
"JFK","1984","Jan","14507","5884","20391"
"JFK","1984","Sep","15435","7305","22740"
"JFK","1984","Dec","13996","6348","20344"
"JFK","1984","Feb","14055","5454","19509"
"JFK","1984","Mar","14919","6037","20956"
"JFK","1984","Apr","14895","6332","21227"
"JFK","1984","May","15990","6746","22736"
"JFK","1984","Oct","15318","6931","22249"
"JFK","1984","Jul","16791","7925","24716"
"JFK","1983","Jul","16159","7558","23717"
"JFK","1983","Dec","15442","6137","21579"
"JFK","1983","Jan","14466","5569","20035"
"JFK","1983","Feb","12589","4698","17287"
"JFK","1983","Jun","14944","6802","21746"
"JFK","1983","Mar","14952","5463","20415"
"JFK","1983","Sep","15359","6723","22082"
"JFK","1983","May","14977","6331","21308"
"JFK","1983","Aug","16594","7312","23906"
"JFK","1983","Nov","15044","5755","20799"
"JFK","1983","Apr","14615","5784","20399"
"JFK","1983","Oct","15496","6519","22015"
"JFK","1982","May","14586","6051","20637"
"JFK","1982","Mar","14374","5263","19637"
"JFK","1982","Jun","14633","6638","21271"
"JFK","1982","Feb","13207","4809","18016"
"JFK","1982","Apr","13690","5462","19152"
"JFK","1982","Nov","14354","5043","19397"
"JFK","1982","Aug","15666","7398","23064"
"JFK","1982","Sep","14428","6529","20957"
"JFK","1982","Jul","15145","7575","22720"
"JFK","1982","Dec","15050","5407","20457"
"JFK","1982","Oct","15038","6135","21173"
"JFK","1982","Jan","13911","5461","19372"
"JFK","1981","Jan","15777","5720","21497"
"JFK","1981","Nov","12867","5124","17991"
"JFK","1981","Apr","14932","6074","21006"
"JFK","1981","Aug","13616","7160","20776"
"JFK","1981","Sep","13480","6243","19723"
"JFK","1981","Oct","13663","5841","19504"
"JFK","1981","Jul","15775","7305","23080"
"JFK","1981","May","14689","6327","21016"
"JFK","1981","Dec","13922","5328","19250"
"JFK","1981","Mar","15509","5729","21238"
"JFK","1981","Feb","13982","5114","19096"
"JFK","1981","Jun","15001","6462","21463"
"JFK","1980","Aug","15037","7623","22660"
"JFK","1980","Oct","14249","6049","20298"
"JFK","1980","Mar","14457","6202","20659"
"JFK","1980","Dec","15588","5769","21357"
"JFK","1980","Jun","14301","6860","21161"
"JFK","1980","May","14097","6608","20705"
"JFK","1980","Apr","14088","6104","20192"
"JFK","1980","Feb","13616","5789","19405"
"JFK","1980","Jan","14781","6155","20936"
"JFK","1980","Nov","14545","5435","19980"
"JFK","1980","Jul","15191","7541","22732"
"JFK","1980","Sep","13724","6550","20274"
"JFK","1979","Nov","13810","5906","19716"
"JFK","1979","Mar","14914","6604","21518"
"JFK","1979","May","13456","7074","20530"
"JFK","1979","Apr","12533","6730","19263"
"JFK","1979","Aug","15520","8182","23702"
"JFK","1979","Oct","14677","6932","21609"
"JFK","1979","Feb","12512","5817","18329"
"JFK","1979","Jan","14309","6397","20706"
"JFK","1979","Dec","14460","6206","20666"
"JFK","1979","Jun","14392","7163","21555"
"JFK","1979","Jul","15531","8174","23705"
"JFK","1979","Sep","14264","7425","21689"
"JFK","1978","Oct","15262","6794","22056"
"JFK","1978","Jan","13642","6275","19917"
"JFK","1978","May","14545","6951","21496"
"JFK","1978","Jun","15108","7344","22452"
"JFK","1978","Sep","14848","7375","22223"
"JFK","1978","Nov","14646","6027","20673"
"JFK","1978","Feb","12623","5379","18002"
"JFK","1978","Mar","15056","6523","21579"
"JFK","1978","Dec","15109","6412","21521"
"JFK","1978","Apr","14618","6416","21034"
"JFK","1978","Jul","15515","8374","23889"
"JFK","1978","Aug","15632","8085","23717"
"JFK","1977","May","14459","6942","21401"
"JFK","1977","Apr","14210","6627","20837"
"JFK","1977","Nov","13727","6218","19945"
"JFK","1977","Jan","13643","6402","20045"
"JFK","1977","Feb","12613","5851","18464"
"JFK","1977","Aug","15233","8227","23460"
"JFK","1977","Dec","14237","6634","20871"
"JFK","1977","Jul","15305","8455","23760"
"JFK","1977","Mar","13843","6489","20332"
"JFK","1977","Sep","14137","7518","21655"
"JFK","1977","Jun","14537","7393","21930"
"JFK","1977","Oct","14245","7089","21334"
"LGA","2015","Nov","26552","1932","28484"
"LGA","2015","Mar","26986","2302","29288"
"LGA","2015","Jul","28744","2502","31246"
"LGA","2015","Oct","28360","2184","30544"
"LGA","2015","Jan","25200","2176","27376"
"LGA","2015","Apr","27880","2456","30336"
"LGA","2015","Jun","26808","2532","29340"
"LGA","2015","May","27384","2595","29979"
"LGA","2015","Feb","22929","2025","24954"
"LGA","2015","Aug","29032","2428","31460"
"LGA","2015","Dec","26167","1862","28029"
"LGA","2015","Sep","27241","2166","29407"
"LGA","2014","Dec","26935","2372","29307"
"LGA","2014","Apr","27717","2715","30432"
"LGA","2014","May","27438","2687","30125"
"LGA","2014","Jan","23778","2455","26233"
