"lastupdatedate","town_no","town","towntotalcases","townconfirmedcases","townprobablecases","towncaserate","towntotaldeaths","townconfirmeddeaths","townprobabledeaths","peopletested","ratetested100k","numberoftests","numberofpositives","numberofnegatives","numberofindeterminates"
"2022-06-24T00:00:00.000","1","Andover","514","439","75","15884","6","4","2","2442","75464","9378","590","8780","8"
"2022-06-24T00:00:00.000","2","Ansonia","4911","4222","689","26327","49","39","10","16305","87408","77023","6048","70818","157"
"2022-06-24T00:00:00.000","3","Ashford","744","671","73","17485","5","4","1","3398","79859","13168","896","12259","13"
"2022-06-24T00:00:00.000","4","Avon","3030","2773","257","16579","81","65","16","17103","93582","74898","3563","71253","82"
"2022-06-24T00:00:00.000","5","Barkhamsted","527","490","37","14615","8","7","1","2698","74820","11013","621","10378","14"
"2022-06-24T00:00:00.000","6","Beacon Falls","1306","1163","143","20990","11","11","0","4909","78897","23227","1591","21591","45"
"2022-06-24T00:00:00.000","7","Berlin","4098","3751","347","20053","52","45","7","16527","80872","75260","4960","70217","83"
"2022-06-24T00:00:00.000","8","Bethany","991","901","90","17862","4","3","1","4654","83886","23382","1211","22140","31"
"2022-06-24T00:00:00.000","9","Bethel","4090","3345","745","20657","71","56","15","18113","91480","74508","4926","69498","84"
"2022-06-24T00:00:00.000","10","Bethlehem","620","529","91","18225","3","2","1","2781","81746","11841","749","11070","22"
"2022-06-24T00:00:00.000","11","Bloomfield","4961","4529","432","23389","136","116","20","20226","95356","133754","6221","127332","201"
"2022-06-24T00:00:00.000","12","Bolton","753","654","99","15418","5","4","1","3960","81081","15008","891","14106","11"
"2022-06-24T00:00:00.000","13","Bozrah","611","561","50","22414","7","7","0","2225","81621","10039","736","9294","9"
"2022-06-24T00:00:00.000","14","Branford","5949","5355","594","21323","82","73","9","25532","91513","124606","7159","117307","140"
"2022-06-24T00:00:00.000","15","Bridgeport","42752","38547","4205","29607","450","370","80","140154","97060","687262","55043","631139","1080"
"2022-06-24T00:00:00.000","16","Bridgewater","201","134","67","12294","0","0","0","1426","87217","5285","241","5038","6"
"2022-06-24T00:00:00.000","17","Bristol","14449","12422","2027","24103","211","172","39","52458","87507","273117","17897","254870","350"
"2022-06-24T00:00:00.000","18","Brookfield","3724","2987","737","21941","27","20","7","15831","93272","62794","4446","58288","60"
"2022-06-24T00:00:00.000","19","Brooklyn","2118","2007","111","25604","18","18","0","7571","91526","45912","2584","43300","28"
"2022-06-24T00:00:00.000","20","Burlington","1750","1498","252","18034","8","6","2","7907","81482","33601","2101","31462","38"
"2022-06-24T00:00:00.000","21","Canaan","29","28","1","2754","0","0","0","357","33903","1284","36","1248","0"
"2022-06-24T00:00:00.000","22","Canterbury","1134","1048","86","22327","4","4","0","4085","80429","17034","1354","15664","16"
"2022-06-24T00:00:00.000","23","Canton","1463","1317","146","14268","39","32","7","8273","80681","35080","1690","33363","27"
"2022-06-24T00:00:00.000","24","Chaplin","445","415","30","19875","3","3","0","1792","80036","7523","530","6991","2"
"2022-06-24T00:00:00.000","25","Cheshire","6364","5640","724","21993","80","66","14","26353","91070","167177","7639","159390","148"
"2022-06-24T00:00:00.000","26","Chester","615","562","53","14598","19","16","3","3516","83456","17261","768","16468","25"
"2022-06-24T00:00:00.000","27","Clinton","2653","2476","177","20526","15","10","5","11835","91567","49167","3216","45893","58"
"2022-06-24T00:00:00.000","28","Colchester","3149","2824","325","19919","42","29","13","13883","87817","63386","3810","59502","74"
"2022-06-24T00:00:00.000","29","Colebrook","146","137","9","10429","1","1","0","857","61214","3665","168","3493","4"
"2022-06-24T00:00:00.000","30","Columbia","973","859","114","18089","13","10","3","4482","83324","17972","1153","16804","15"
"2022-06-24T00:00:00.000","31","Cornwall","190","181","9","13950","2","0","2","1404","103084","5033","218","4812","3"
"2022-06-24T00:00:00.000","32","Coventry","2116","1828","288","17055","11","10","1","9938","80100","38474","2482","35951","41"
"2022-06-24T00:00:00.000","33","Cromwell","2969","2654","315","21454","66","42","24","12614","91148","66660","3642","62929","89"
"2022-06-24T00:00:00.000","34","Danbury","21006","18829","2177","24802","218","181","37","80853","95465","322956","25786","296675","495"
"2022-06-24T00:00:00.000","35","Darien","3887","3425","462","17889","13","12","1","22639","104193","91960","4723","87157","80"
"2022-06-24T00:00:00.000","36","Deep River","756","707","49","17016","1","1","0","3837","86361","15651","915","14716","20"
"2022-06-24T00:00:00.000","37","Derby","3124","2655","469","25318","30","24","6","10968","88889","50108","3824","46191","93"
"2022-06-24T00:00:00.000","38","Durham","1469","1331","138","20502","9","8","1","6189","86378","29843","1778","28037","28"
"2022-06-24T00:00:00.000","39","Eastford","279","266","13","15587","4","3","1","1222","68268","4467","332","4134","1"
"2022-06-24T00:00:00.000","40","East Granby","885","781","104","17218","4","2","2","4368","84981","18079","1084","16984","11"
"2022-06-24T00:00:00.000","41","East Haddam","1338","1162","176","14872","23","10","13","6801","75592","30531","1571","28933","27"
"2022-06-24T00:00:00.000","42","East Hampton","2350","2025","325","18359","25","18","7","10614","82922","45587","2821","42716","50"
"2022-06-24T00:00:00.000","43","East Hartford","13749","12490","1259","27569","198","155","43","44932","90095","227626","17375","209914","337"
"2022-06-24T00:00:00.000","44","East Haven","7630","6642","988","26707","107","87","20","25870","90553","126811","9380","117307","124"
"2022-06-24T00:00:00.000","45","East Lyme","3736","3454","282","20236","62","49","13","18023","97622","93925","4468","89400","57"
"2022-06-24T00:00:00.000","46","Easton","1410","1232","178","18748","5","4","1","7098","94376","26607","1720","24858","29"
"2022-06-24T00:00:00.000","47","East Windsor","2220","2004","216","19026","61","46","15","9273","79474","46872","2736","44071","65"
"2022-06-24T00:00:00.000","48","Ellington","2381","2163","218","14459","33","21","12","12202","74100","42677","2770","39858","49"
"2022-06-24T00:00:00.000","49","Enfield","9156","8278","878","20972","89","79","10","34820","79754","186929","11198","175453","278"
"2022-06-24T00:00:00.000","50","Essex","1068","984","84","16017","13","12","1","5891","88347","26952","1324","25604","24"
"2022-06-24T00:00:00.000","51","Fairfield","15157","13628","1529","24429","244","185","59","65671","105844","374360","18148","355811","401"
"2022-06-24T00:00:00.000","52","Farmington","4614","4066","548","18096","67","54","13","23477","92077","114227","5479","108602","146"
"2022-06-24T00:00:00.000","53","Franklin","435","409","26","22656","2","2","0","1495","77865","6886","530","6347","9"
"2022-06-24T00:00:00.000","54","Glastonbury","6159","5462","697","17861","119","98","21","30213","87620","126954","7512","119303","139"
"2022-06-24T00:00:00.000","55","Goshen","447","414","33","15613","2","2","0","2471","86308","9660","544","9107","9"
"2022-06-24T00:00:00.000","56","Granby","1559","1353","206","13548","33","28","5","8955","77822","35940","1854","34044","42"
"2022-06-24T00:00:00.000","57","Greenwich","14417","13413","1004","22942","124","100","24","66407","105676","301221","17573","283422","226"
"2022-06-24T00:00:00.000","58","Griswold","2927","2670","257","25377","32","23","9","10222","88625","45075","3540","41501","34"
"2022-06-24T00:00:00.000","59","Groton","7937","7098","839","20650","122","78","44","33380","86846","148959","9568","139244","147"
"2022-06-24T00:00:00.000","60","Guilford","4363","3978","385","19713","45","35","10","20550","92848","100762","5168","95501","93"
"2022-06-24T00:00:00.000","61","Haddam","1426","1328","98","17405","11","6","5","6866","83803","29961","1723","28217","21"
"2022-06-24T00:00:00.000","62","Hamden","14170","12307","1863","23400","234","199","35","58777","97062","411736","17427","393890","419"
"2022-06-24T00:00:00.000","63","Hampton","466","441","25","25299","1","1","0","1888","102497","7835","552","7280","3"
"2022-06-24T00:00:00.000","64","Hartford","33844","31546","2298","27717","417","368","49","114909","94107","678223","42545","634741","937"
"2022-06-24T00:00:00.000","65","Hartland","249","225","24","11745","5","4","1","1328","62642","4991","300","4685","6"
"2022-06-24T00:00:00.000","66","Harwinton","1013","930","83","18690","9","6","3","4379","80793","18676","1221","17431","24"
"2022-06-24T00:00:00.000","67","Hebron","1561","1367","194","16425","15","11","4","7531","79240","30254","1872","28356","26"
"2022-06-24T00:00:00.000","68","Kent","555","504","51","19986","2","2","0","3876","139575","23978","669","23307","2"
"2022-06-24T00:00:00.000","69","Killingly","4550","4317","233","26246","80","57","23","15358","88590","68133","5510","62565","58"
"2022-06-24T00:00:00.000","70","Killingworth","1084","989","95","17033","11","6","5","5399","84837","23739","1270","22440","29"
"2022-06-24T00:00:00.000","71","Lebanon","1426","1308","118","19961","7","6","1","6032","84434","26223","1730","24476","17"
"2022-06-24T00:00:00.000","72","Ledyard","3349","3047","302","22905","14","13","1","13700","93701","57505","3959","53481","65"
"2022-06-24T00:00:00.000","73","Lisbon","900","821","79","21327","13","13","0","3141","74431","14329","1100","13204","25"
"2022-06-24T00:00:00.000","74","Litchfield","1295","1170","125","16000","13","11","2","6901","85261","30029","1526","28471","32"
"2022-06-24T00:00:00.000","75","Lyme","328","303","25","14162","1","0","1","1962","84715","7777","387","7386","4"
"2022-06-24T00:00:00.000","76","Madison","3406","3144","262","18891","46","36","10","17608","97659","83611","4060","79474","77"
"2022-06-24T00:00:00.000","77","Manchester","11838","10341","1497","20558","192","139","53","48821","84782","222298","14519","207511","268"
"2022-06-24T00:00:00.000","78","Mansfield","2969","2687","282","11649","32","27","5","17367","68141","97917","3412","94400","105"
"2022-06-24T00:00:00.000","79","Marlborough","1152","987","165","18185","31","22","9","5300","83662","26138","1422","24689","27"
"2022-06-24T00:00:00.000","80","Meriden","17364","15775","1589","29235","220","195","25","56152","94540","316476","21796","294243","437"
"2022-06-24T00:00:00.000","81","Middlebury","1628","1356","272","20877","23","18","5","7224","92639","35606","2038","33498","70"
"2022-06-24T00:00:00.000","82","Middlefield","714","639","75","16324","5","3","2","3669","83882","17077","922","16141","14"
"2022-06-24T00:00:00.000","83","Middletown","10999","10030","969","23778","184","136","48","43816","94721","464207","13818","449891","498"
"2022-06-24T00:00:00.000","84","Milford","12274","11098","1176","22419","184","160","24","46611","85139","221441","15152","206076","213"
"2022-06-24T00:00:00.000","85","Monroe","4161","3519","642","21411","25","17","8","17318","89112","71035","5022","65948","65"
"2022-06-24T00:00:00.000","86","Montville","4584","4221","363","24768","49","44","5","16980","91744","99668","5490","94067","111"
"2022-06-24T00:00:00.000","87","Morris","336","309","27","14907","3","3","0","1822","80834","7426","392","7028","6"
"2022-06-24T00:00:00.000","88","Naugatuck","8304","6905","1399","26694","141","123","18","27464","88286","151480","10601","140573","306"
"2022-06-24T00:00:00.000","89","New Britain","20438","18802","1636","28192","273","225","48","64298","88693","316164","25454","290220","490"
"2022-06-24T00:00:00.000","90","New Canaan","3642","3233","409","18000","44","38","6","21715","107325","86617","4334","82218","65"
"2022-06-24T00:00:00.000","91","New Fairfield","2591","2163","428","18670","9","6","3","11738","84580","41933","3047","38842","44"
"2022-06-24T00:00:00.000","92","New Hartford","1116","1039","77","16767","6","5","1","5250","78876","20742","1341","19382","19"
"2022-06-24T00:00:00.000","93","New Haven","35872","33235","2637","27541","289","256","33","128564","98706","928333","44649","882389","1295"
"2022-06-24T00:00:00.000","94","Newington","6758","6240","518","22516","138","117","21","26464","88172","129334","8391","120776","167"
"2022-06-24T00:00:00.000","95","New London","8000","7472","528","29786","50","44","6","30824","114767","338067","9808","327960","299"
"2022-06-24T00:00:00.000","96","New Milford","5277","3579","1698","19687","63","45","18","24041","89688","104637","6228","98266","143"
"2022-06-24T00:00:00.000","97","Newtown","5148","4260","888","18458","80","68","12","24660","88416","116768","6169","110507","92"
"2022-06-24T00:00:00.000","98","Norfolk","141","132","9","8650","1","1","0","793","48650","3470","164","3303","3"
"2022-06-24T00:00:00.000","99","North Branford","3212","2768","444","22706","29","15","14","11770","83204","56893","3860","52976","57"
"2022-06-24T00:00:00.000","100","North Canaan","550","531","19","16918","19","18","1","3095","95201","18063","627","17418","18"
"2022-06-24T00:00:00.000","101","North Haven","6038","4935","1103","25495","66","62","4","22286","94101","112875","7353","105422","100"
"2022-06-24T00:00:00.000","102","North Stonington","1015","930","85","19534","9","7","2","4009","77156","15615","1193","14411","11"
"2022-06-24T00:00:00.000","103","Norwalk","23415","21263","2152","26363","271","236","35","89655","100945","381564","29983","351163","418"
"2022-06-24T00:00:00.000","104","Norwich","10662","9520","1142","27502","102","87","15","36704","94676","167559","13264","154145","150"
"2022-06-24T00:00:00.000","105","Old Lyme","1329","1254","75","18191","4","3","1","7210","98686","28323","1615","26684","24"
"2022-06-24T00:00:00.000","106","Old Saybrook","2175","2027","148","21618","66","53","13","10197","101352","47564","2661","44861","42"
"2022-06-24T00:00:00.000","107","Orange","3025","2724","301","21722","24","21","3","12871","92424","55427","3600","51777","50"
"2022-06-24T00:00:00.000","108","Oxford","2537","2250","287","19140","33","32","1","10792","81418","45124","3100","41974","50"
"2022-06-24T00:00:00.000","109","Plainfield","3894","3605","289","25745","55","47","8","12681","83841","56474","4725","51721","28"
"2022-06-24T00:00:00.000","110","Plainville","3946","3373","573","22505","60","57","3","14572","83107","73472","4916","68463","93"
"2022-06-24T00:00:00.000","111","Plymouth","2405","2050","355","20736","19","16","3","9458","81549","45109","2960","42093","56"
"2022-06-24T00:00:00.000","112","Pomfret","821","729","92","19534","7","6","1","4434","105496","21895","992","20893","10"
"2022-06-24T00:00:00.000","113","Portland","1669","1519","150","18010","30","22","8","8051","86878","40007","2033","37938","36"
"2022-06-24T00:00:00.000","114","Preston","1096","994","102","23697","9","9","0","4112","88908","18476","1284","17165","27"
"2022-06-24T00:00:00.000","115","Prospect","2107","1812","295","21717","10","10","0","7915","81581","36845","2614","34180","51"
"2022-06-24T00:00:00.000","116","Putnam","2231","2130","101","23762","36","33","3","8169","87006","32166","2693","29446","27"
"2022-06-24T00:00:00.000","117","Redding","1418","1255","163","15555","22","18","4","8014","87911","32514","1758","30722","34"
"2022-06-24T00:00:00.000","118","Ridgefield","4400","3950","450","17629","69","52","17","23921","95841","99587","5375","94116","96"
"2022-06-24T00:00:00.000","119","Rocky Hill","4338","3857","481","21566","150","126","24","17279","85901","89774","5542","84099","133"
"2022-06-24T00:00:00.000","120","Roxbury","318","227","91","14777","2","0","2","1953","90753","6869","368","6498","3"
"2022-06-24T00:00:00.000","121","Salem","833","781","52","20402","5","5","0","3551","86970","14928","1028","13884","16"
"2022-06-24T00:00:00.000","122","Salisbury","551","491","60","15306","2","1","1","5152","143111","22848","654","22181","13"
"2022-06-24T00:00:00.000","123","Scotland","123","119","4","7356","2","2","0","483","28888","2072","151","1921","0"
"2022-06-24T00:00:00.000","124","Seymour","4017","3552","465","24439","83","68","15","14257","86737","70201","4882","65180","139"
"2022-06-24T00:00:00.000","125","Sharon","295","285","10","10971","4","3","1","2248","83600","9507","362","9142","3"
"2022-06-24T00:00:00.000","126","Shelton","9900","8633","1267","24071","212","169","43","37229","90518","174081","12177","161633","271"
"2022-06-24T00:00:00.000","127","Sherman","520","358","162","14325","3","0","3","3119","85923","10532","581","9932","19"
"2022-06-24T00:00:00.000","128","Simsbury","3694","3353","341","14546","34","29","5","22027","86738","94183","4327","89769","87"
"2022-06-24T00:00:00.000","129","Somers","2111","1946","165","19575","23","20","3","8345","77383","60154","2462","57614","78"
"2022-06-24T00:00:00.000","130","Southbury","3594","2912","682","18364","85","72","13","17174","87752","88372","4533","83743","96"
"2022-06-24T00:00:00.000","131","Southington","9287","7931","1356","21187","135","115","20","36444","83141","182821","11447","171159","215"
"2022-06-24T00:00:00.000","132","South Windsor","4644","4183","461","17751","67","44","23","21422","81882","81071","5456","75502","113"
"2022-06-24T00:00:00.000","133","Sprague","767","698","69","26828","6","5","1","2702","94509","13758","924","12823","11"
"2022-06-24T00:00:00.000","134","Stafford","1718","1557","161","14445","34","26","8","7483","62919","33831","2095","31702","34"
"2022-06-24T00:00:00.000","135","Stamford","31230","28824","2406","24090","385","337","48","130989","101042","495088","39918","454672","498"
"2022-06-24T00:00:00.000","136","Sterling","767","710","57","20280","3","3","0","2760","72977","10505","910","9584","11"
"2022-06-24T00:00:00.000","137","Stonington","3554","3211","343","19150","60","40","20","16616","89531","74837","4376","70400","61"
"2022-06-24T00:00:00.000","138","Stratford","13974","11967","2007","26951","201","166","35","48536","93610","227886","17441","210150","295"
"2022-06-24T00:00:00.000","139","Suffield","3659","3134","525","23138","51","39","12","14585","92228","117510","4488","112942","80"
"2022-06-24T00:00:00.000","140","Thomaston","1874","1578","296","24871","18","18","0","6353","84313","31275","2348","28899","28"
"2022-06-24T00:00:00.000","141","Thompson","1824","1720","104","19448","14","9","5","6595","70317","26528","2173","24313","42"
"2022-06-24T00:00:00.000","142","Tolland","2308","2072","236","15789","25","12","13","11652","79710","45876","2709","43119","48"
"2022-06-24T00:00:00.000","143","Torrington","7985","7554","431","23455","183","163","20","29536","86758","155987","9842","145885","260"
"2022-06-24T00:00:00.000","144","Trumbull","8929","7819","1110","25030","177","123","54","35614","99835","166747","11059","155464","224"
"2022-06-24T00:00:00.000","145","Union","217","200","17","25864","2","2","0","1088","129678","4361","252","4105","4"
"2022-06-24T00:00:00.000","146","Vernon","5058","4538","520","17228","78","52","26","22358","76154","91898","5904","85864","130"
"2022-06-24T00:00:00.000","147","Voluntown","527","492","35","20996","6","6","0","2122","84542","8416","624","7785","7"
"2022-06-24T00:00:00.000","148","Wallingford","10754","9587","1167","24261","217","187","30","40293","90902","234261","13245","220742","274"
"2022-06-24T00:00:00.000","149","Warren","157","115","42","11254","0","0","0","1033","74050","3841","179","3657","5"
"2022-06-24T00:00:00.000","150","Washington","538","444","94","15694","2","2","0","4008","116919","17907","614","17277","16"
"2022-06-24T00:00:00.000","151","Waterbury","33783","29531","4252","31406","503","442","61","106841","99324","545711","43572","501226","913"
"2022-06-24T00:00:00.000","152","Waterford","4483","4184","299","23914","77","57","20","18140","96767","87372","5401","81881","90"
"2022-06-24T00:00:00.000","153","Watertown","5227","4459","768","24224","78","71","7","19443","90106","95655","6663","88841","151"
"2022-06-24T00:00:00.000","154","Westbrook","1324","1242","82","19275","10","6","4","6202","90290","24212","1629","22555","28"
"2022-06-24T00:00:00.000","155","West Hartford","11778","10424","1354","18706","274","207","67","58884","93519","294006","14399","279307","300"
"2022-06-24T00:00:00.000","156","West Haven","13699","11960","1739","25081","164","149","15","49518","90659","242999","17082","225642","275"
"2022-06-24T00:00:00.000","157","Weston","1691","1536","155","16494","5","3","2","10342","100878","41154","2054","39067","33"
"2022-06-24T00:00:00.000","158","Westport","5238","4787","451","18385","37","27","10","30560","107262","144808","6382","138315","111"
"2022-06-24T00:00:00.000","159","Wethersfield","5968","5513","455","22947","55","46","9","22942","88211","108065","7358","100587","120"
"2022-06-24T00:00:00.000","160","Willington","815","732","83","13898","4","4","0","4123","70310","16426","934","15478","14"
"2022-06-24T00:00:00.000","161","Wilton","3255","2989","266","17745","55","29","26","18832","102666","72628","3903","68696","29"
"2022-06-24T00:00:00.000","162","Winchester","1838","1763","75","17333","16","16","0","8298","78253","33990","2166","31799","25"
"2022-06-24T00:00:00.000","163","Windham","6986","6560","426","28443","71","48","23","22379","91116","117233","8998","108089","146"
"2022-06-24T00:00:00.000","164","Windsor","7056","6452","604","24557","164","126","38","27217","94724","152809","8921","143724","164"
"2022-06-24T00:00:00.000","165","Windsor Locks","2702","2507","195","21021","44","40","4","10507","81741","44778","3347","41376","55"
"2022-06-24T00:00:00.000","166","Wolcott","4089","3557","532","24652","64","54","10","14324","86357","71416","5163","66148","105"
"2022-06-24T00:00:00.000","167","Woodbridge","1699","1519","180","19417","48","42","6","8668","99063","50559","2115","48373","71"
"2022-06-24T00:00:00.000","168","Woodbury","1646","1367","279","17323","12","10","2","7918","83330","34243","2023","32192","28"
"2022-06-24T00:00:00.000","169","Woodstock","1440","1391","49","18325","7","7","0","6740","85772","23654","1680","21945","29"
"2022-06-23T00:00:00.000","1","Andover","512","438","74","15822","6","4","2","2439","75371","9373","588","8777","8"
"2022-06-23T00:00:00.000","2","Ansonia","4904","4215","689","26289","49","39","10","16305","87408","76963","6039","70767","157"
"2022-06-23T00:00:00.000","3","Ashford","744","671","73","17485","5","4","1","3397","79835","13160","896","12251","13"
"2022-06-23T00:00:00.000","4","Avon","3020","2768","252","16524","81","65","16","17088","93500","74721","3549","71091","81"
"2022-06-23T00:00:00.000","5","Barkhamsted","526","490","36","14587","8","7","1","2697","74792","11007","620","10373","14"
"2022-06-23T00:00:00.000","6","Beacon Falls","1305","1162","143","20974","11","11","0","4907","78865","23201","1588","21568","45"
"2022-06-23T00:00:00.000","7","Berlin","4096","3750","346","20043","52","45","7","16525","80862","75239","4956","70200","83"
"2022-06-23T00:00:00.000","8","Bethany","991","901","90","17862","4","3","1","4656","83922","23370","1211","22128","31"
"2022-06-23T00:00:00.000","9","Bethel","4087","3342","745","20641","71","56","15","18110","91465","74488","4922","69482","84"
"2022-06-23T00:00:00.000","10","Bethlehem","619","528","91","18195","3","2","1","2785","81864","11841","749","11070","22"
"2022-06-23T00:00:00.000","11","Bloomfield","4960","4529","431","23384","136","116","20","20224","95347","133680","6218","127261","201"
"2022-06-23T00:00:00.000","12","Bolton","753","654","99","15418","5","4","1","3960","81081","14988","891","14086","11"
"2022-06-23T00:00:00.000","13","Bozrah","610","560","50","22377","7","7","0","2229","81768","10035","735","9291","9"
"2022-06-23T00:00:00.000","14","Branford","5940","5346","594","21290","82","73","9","25525","91487","124561","7150","117271","140"
"2022-06-23T00:00:00.000","15","Bridgeport","42725","38520","4205","29588","450","370","80","140119","97036","686908","55010","630819","1079"
"2022-06-23T00:00:00.000","16","Bridgewater","201","134","67","12294","0","0","0","1425","87156","5281","241","5034","6"
"2022-06-23T00:00:00.000","17","Bristol","14441","12415","2026","24090","211","172","39","52449","87492","272946","17885","254710","351"
"2022-06-23T00:00:00.000","18","Brookfield","3720","2983","737","21917","27","20","7","15830","93266","62703","4442","58201","60"
"2022-06-23T00:00:00.000","19","Brooklyn","2118","2007","111","25604","18","18","0","7569","91501","45708","2585","43095","28"
"2022-06-23T00:00:00.000","20","Burlington","1747","1495","252","18003","8","6","2","7898","81389","33569","2098","31433","38"
"2022-06-23T00:00:00.000","21","Canaan","29","28","1","2754","0","0","0","357","33903","1284","36","1248","0"
"2022-06-23T00:00:00.000","22","Canterbury","1133","1048","85","22308","4","4","0","4084","80410","17018","1353","15649","16"
"2022-06-23T00:00:00.000","23","Canton","1462","1316","146","14258","39","32","7","8269","80642","35063","1689","33348","26"
"2022-06-23T00:00:00.000","24","Chaplin","445","415","30","19875","3","3","0","1793","80080","7520","530","6988","2"
"2022-06-23T00:00:00.000","25","Cheshire","6363","5641","722","21989","80","66","14","26357","91084","166480","7637","158695","148"
"2022-06-23T00:00:00.000","26","Chester","613","559","54","14550","19","16","3","3514","83408","17250","765","16460","25"
"2022-06-23T00:00:00.000","27","Clinton","2649","2471","178","20495","15","10","5","11833","91551","49133","3212","45863","58"
"2022-06-23T00:00:00.000","28","Colchester","3143","2819","324","19881","42","29","13","13886","87836","63310","3806","59430","74"
"2022-06-23T00:00:00.000","29","Colebrook","146","137","9","10429","1","1","0","856","61143","3666","169","3493","4"
"2022-06-23T00:00:00.000","30","Columbia","973","859","114","18089","13","10","3","4482","83324","17981","1153","16813","15"
"2022-06-23T00:00:00.000","31","Cornwall","190","181","9","13950","2","0","2","1405","103157","5040","218","4819","3"
"2022-06-23T00:00:00.000","32","Coventry","2115","1827","288","17047","11","10","1","9936","80084","38471","2481","35949","41"
"2022-06-23T00:00:00.000","33","Cromwell","2967","2652","315","21439","66","42","24","12614","91148","66607","3640","62878","89"
"2022-06-23T00:00:00.000","34","Danbury","20996","18819","2177","24790","218","181","37","80828","95435","322764","25772","296498","494"
"2022-06-23T00:00:00.000","35","Darien","3886","3424","462","17885","13","12","1","22642","104207","91923","4721","87123","79"
"2022-06-23T00:00:00.000","36","Deep River","756","707","49","17016","1","1","0","3838","86383","15645","915","14710","20"
"2022-06-23T00:00:00.000","37","Derby","3123","2654","469","25310","30","24","6","10971","88913","50071","3822","46156","93"
"2022-06-23T00:00:00.000","38","Durham","1467","1329","138","20475","9","8","1","6188","86364","29823","1776","28019","28"
"2022-06-23T00:00:00.000","39","Eastford","279","266","13","15587","4","3","1","1222","68268","4468","332","4135","1"
"2022-06-23T00:00:00.000","40","East Granby","883","780","103","17179","4","2","2","4367","84961","18068","1082","16976","10"
"2022-06-23T00:00:00.000","41","East Haddam","1337","1160","177","14861","23","10","13","6796","75536","30496","1570","28899","27"
"2022-06-23T00:00:00.000","42","East Hampton","2347","2022","325","18336","25","18","7","10612","82906","45566","2816","42700","50"
"2022-06-23T00:00:00.000","43","East Hartford","13740","12484","1256","27551","198","155","43","44917","90065","227479","17360","209782","337"
"2022-06-23T00:00:00.000","44","East Haven","7625","6637","988","26690","107","87","20","25866","90539","126781","9376","117281","124"
"2022-06-23T00:00:00.000","45","East Lyme","3734","3452","282","20225","62","49","13","18027","97644","93918","4465","89396","57"
"2022-06-23T00:00:00.000","46","Easton","1408","1230","178","18721","5","4","1","7095","94336","26588","1717","24842","29"
"2022-06-23T00:00:00.000","47","East Windsor","2217","2002","215","19001","61","46","15","9269","79439","46816","2731","44021","64"
"2022-06-23T00:00:00.000","48","Ellington","2378","2160","218","14441","33","21","12","12199","74081","42651","2767","39835","49"
"2022-06-23T00:00:00.000","49","Enfield","9154","8276","878","20967","89","79","10","34814","79741","186761","11192","175291","278"
"2022-06-23T00:00:00.000","50","Essex","1065","981","84","15972","13","12","1","5888","88302","26958","1319","25615","24"
"2022-06-23T00:00:00.000","51","Fairfield","15135","13605","1530","24394","244","185","59","65649","105809","374155","18122","355633","400"
"2022-06-23T00:00:00.000","52","Farmington","4608","4060","548","18073","67","54","13","23471","92054","114221","5472","108603","146"
"2022-06-23T00:00:00.000","53","Franklin","435","409","26","22656","2","2","0","1492","77708","6871","530","6332","9"
"2022-06-23T00:00:00.000","54","Glastonbury","6147","5453","694","17827","119","98","21","30206","87599","126864","7496","119229","139"
"2022-06-23T00:00:00.000","55","Goshen","447","414","33","15613","2","2","0","2471","86308","9656","543","9104","9"
"2022-06-23T00:00:00.000","56","Granby","1554","1348","206","13505","33","28","5","8957","77840","35934","1849","34043","42"
"2022-06-23T00:00:00.000","57","Greenwich","14396","13397","999","22909","124","100","24","66390","105649","300993","17547","283221","225"
"2022-06-23T00:00:00.000","58","Griswold","2923","2666","257","25342","32","23","9","10215","88564","45042","3535","41473","34"
"2022-06-23T00:00:00.000","59","Groton","7931","7092","839","20634","122","78","44","33362","86799","148828","9561","139120","147"
"2022-06-23T00:00:00.000","60","Guilford","4356","3972","384","19681","45","35","10","20542","92812","100675","5160","95422","93"
"2022-06-23T00:00:00.000","61","Haddam","1424","1327","97","17381","11","6","5","6861","83742","29944","1722","28201","21"
"2022-06-23T00:00:00.000","62","Hamden","14162","12301","1861","23387","234","199","35","58758","97031","411440","17414","393607","419"
"2022-06-23T00:00:00.000","63","Hampton","466","441","25","25299","1","1","0","1886","102389","7829","552","7274","3"
"2022-06-23T00:00:00.000","64","Hartford","33822","31528","2294","27699","417","368","49","114906","94104","677855","42519","634399","937"
"2022-06-23T00:00:00.000","65","Hartland","246","223","23","11604","5","4","1","1327","62594","4981","297","4678","6"
"2022-06-23T00:00:00.000","66","Harwinton","1013","930","83","18690","9","6","3","4374","80701","18662","1220","17418","24"
"2022-06-23T00:00:00.000","67","Hebron","1559","1366","193","16404","15","11","4","7521","79135","30220","1869","28325","26"
"2022-06-23T00:00:00.000","68","Kent","556","505","51","20022","2","2","0","3883","139827","23996","670","23324","2"
"2022-06-23T00:00:00.000","69","Killingly","4544","4311","233","26211","80","57","23","15352","88556","68063","5503","62502","58"
"2022-06-23T00:00:00.000","70","Killingworth","1082","986","96","17002","11","6","5","5395","84774","23723","1267","22427","29"
"2022-06-23T00:00:00.000","71","Lebanon","1425","1307","118","19947","7","6","1","6031","84420","26209","1728","24464","17"
"2022-06-23T00:00:00.000","72","Ledyard","3344","3043","301","22871","14","13","1","13695","93667","57469","3952","53454","63"
"2022-06-23T00:00:00.000","73","Lisbon","900","821","79","21327","13","13","0","3137","74336","14316","1099","13192","25"
"2022-06-23T00:00:00.000","74","Litchfield","1294","1169","125","15987","13","11","2","6902","85273","29993","1525","28436","32"
"2022-06-23T00:00:00.000","75","Lyme","328","303","25","14162","1","0","1","1962","84715","7775","387","7384","4"
"2022-06-23T00:00:00.000","76","Madison","3404","3142","262","18880","46","36","10","17603","97632","83581","4055","79449","77"
"2022-06-23T00:00:00.000","77","Manchester","11818","10323","1495","20523","192","139","53","48803","84751","222135","14493","207374","268"
"2022-06-23T00:00:00.000","78","Mansfield","2968","2686","282","11645","32","27","5","17368","68145","97885","3411","94369","105"
"2022-06-23T00:00:00.000","79","Marlborough","1150","986","164","18153","31","22","9","5299","83646","26127","1420","24680","27"
"2022-06-23T00:00:00.000","80","Meriden","17355","15767","1588","29220","220","195","25","56139","94518","316285","21782","294067","436"
"2022-06-23T00:00:00.000","81","Middlebury","1628","1356","272","20877","23","18","5","7222","92613","35584","2037","33477","70"
"2022-06-23T00:00:00.000","82","Middlefield","713","638","75","16301","5","3","2","3669","83882","17063","920","16129","14"
"2022-06-23T00:00:00.000","83","Middletown","10987","10019","968","23752","184","136","48","43794","94673","464068","13802","449768","498"
"2022-06-23T00:00:00.000","84","Milford","12265","11089","1176","22403","184","160","24","46622","85159","221316","15137","205966","213"
"2022-06-23T00:00:00.000","85","Monroe","4157","3515","642","21390","25","17","8","17319","89117","70977","5017","65895","65"
"2022-06-23T00:00:00.000","86","Montville","4578","4215","363","24735","49","44","5","16976","91722","99591","5482","93998","111"
"2022-06-23T00:00:00.000","87","Morris","336","309","27","14907","3","3","0","1823","80878","7431","392","7033","6"
"2022-06-23T00:00:00.000","88","Naugatuck","8296","6900","1396","26668","141","123","18","27458","88267","151377","10592","140479","306"
"2022-06-23T00:00:00.000","89","New Britain","20422","18791","1631","28170","273","225","48","64279","88667","316104","25434","290181","489"
"2022-06-23T00:00:00.000","90","New Canaan","3642","3233","409","18000","44","38","6","21713","107315","86570","4333","82172","65"
"2022-06-23T00:00:00.000","91","New Fairfield","2589","2161","428","18655","9","6","3","11739","84587","41912","3044","38824","44"
"2022-06-23T00:00:00.000","92","New Hartford","1116","1039","77","16767","6","5","1","5246","78816","20716","1341","19356","19"
"2022-06-23T00:00:00.000","93","New Haven","35848","33214","2634","27522","289","256","33","128512","98666","927795","44615","881884","1296"
"2022-06-23T00:00:00.000","94","Newington","6750","6233","517","22490","138","117","21","26460","88159","129265","8381","120717","167"
"2022-06-23T00:00:00.000","95","New London","7992","7465","527","29756","50","44","6","30816","114737","338006","9797","327910","299"
"2022-06-23T00:00:00.000","96","New Milford","5275","3577","1698","19679","63","45","18","24037","89674","104607","6231","98233","143"
"2022-06-23T00:00:00.000","97","Newtown","5148","4260","888","18458","80","68","12","24649","88376","116505","6170","110243","92"
"2022-06-23T00:00:00.000","98","Norfolk","141","132","9","8650","1","1","0","794","48712","3471","164","3304","3"
"2022-06-23T00:00:00.000","99","North Branford","3209","2765","444","22685","29","15","14","11771","83211","56857","3857","52943","57"
"2022-06-23T00:00:00.000","100","North Canaan","550","531","19","16918","19","18","1","3095","95201","18055","627","17410","18"
"2022-06-23T00:00:00.000","101","North Haven","6037","4935","1102","25491","66","62","4","22283","94089","112810","7350","105360","100"
"2022-06-23T00:00:00.000","102","North Stonington","1012","927","85","19477","9","7","2","4012","77213","15612","1189","14412","11"
"2022-06-23T00:00:00.000","103","Norwalk","23396","21246","2150","26342","271","236","35","89638","100926","381351","29960","350973","418"
"2022-06-23T00:00:00.000","104","Norwich","10651","9513","1138","27474","102","87","15","36686","94630","167467","13245","154072","150"
"2022-06-23T00:00:00.000","105","Old Lyme","1326","1252","74","18149","4","3","1","7205","98618","28312","1612","26676","24"
"2022-06-23T00:00:00.000","106","Old Saybrook","2173","2025","148","21598","66","53","13","10193","101312","47546","2657","44847","42"
"2022-06-23T00:00:00.000","107","Orange","3023","2722","301","21708","24","21","3","12871","92424","55394","3598","51746","50"
"2022-06-23T00:00:00.000","108","Oxford","2531","2244","287","19095","33","32","1","10791","81411","45102","3094","41958","50"
"2022-06-23T00:00:00.000","109","Plainfield","3891","3603","288","25726","55","47","8","12675","83802","56442","4721","51693","28"
"2022-06-23T00:00:00.000","110","Plainville","3945","3372","573","22499","60","57","3","14555","83010","73374","4912","68369","93"
"2022-06-23T00:00:00.000","111","Plymouth","2402","2048","354","20710","19","16","3","9457","81540","45091","2956","42079","56"
"2022-06-23T00:00:00.000","112","Pomfret","821","729","92","19534","7","6","1","4436","105544","21895","993","20892","10"
"2022-06-23T00:00:00.000","113","Portland","1663","1512","151","17945","30","22","8","8046","86824","39959","2026","37897","36"
"2022-06-23T00:00:00.000","114","Preston","1095","993","102","23676","9","9","0","4110","88865","18461","1283","17151","27"
"2022-06-23T00:00:00.000","115","Prospect","2106","1811","295","21707","10","10","0","7907","81499","36820","2613","34156","51"
"2022-06-23T00:00:00.000","116","Putnam","2229","2128","101","23741","36","33","3","8162","86932","32142","2691","29424","27"
"2022-06-23T00:00:00.000","117","Redding","1418","1255","163","15555","22","18","4","8010","87867","32502","1757","30711","34"
"2022-06-23T00:00:00.000","118","Ridgefield","4392","3942","450","17597","69","52","17","23909","95793","99527","5366","94065","96"
"2022-06-23T00:00:00.000","119","Rocky Hill","4332","3854","478","21536","150","126","24","17278","85896","89772","5533","84107","132"
"2022-06-23T00:00:00.000","120","Roxbury","318","227","91","14777","2","0","2","1952","90706","6866","368","6495","3"
"2022-06-23T00:00:00.000","121","Salem","832","780","52","20377","5","5","0","3552","86995","14923","1027","13880","16"
"2022-06-23T00:00:00.000","122","Salisbury","551","491","60","15306","2","1","1","5152","143111","22839","653","22173","13"
"2022-06-23T00:00:00.000","123","Scotland","123","119","4","7356","2","2","0","482","28828","2068","151","1917","0"
"2022-06-23T00:00:00.000","124","Seymour","4008","3544","464","24384","83","68","15","14256","86731","70098","4872","65088","138"
"2022-06-23T00:00:00.000","125","Sharon","294","284","10","10933","4","3","1","2244","83451","9508","361","9144","3"
"2022-06-23T00:00:00.000","126","Shelton","9888","8621","1267","24041","212","169","43","37224","90505","173990","12164","161555","271"
"2022-06-23T00:00:00.000","127","Sherman","520","358","162","14325","3","0","3","3119","85923","10522","581","9922","19"
"2022-06-23T00:00:00.000","128","Simsbury","3687","3346","341","14519","34","29","5","22021","86714","94133","4321","89725","87"
"2022-06-23T00:00:00.000","129","Somers","2106","1941","165","19529","23","20","3","8341","77346","60077","2457","57542","78"
"2022-06-23T00:00:00.000","130","Southbury","3589","2908","681","18338","85","72","13","17163","87696","88271","4528","83647","96"
"2022-06-23T00:00:00.000","131","Southington","9278","7923","1355","21166","135","115","20","36430","83109","182669","11433","171022","214"
"2022-06-23T00:00:00.000","132","South Windsor","4637","4175","462","17724","67","44","23","21417","81863","80984","5446","75425","113"
"2022-06-23T00:00:00.000","133","Sprague","766","697","69","26793","6","5","1","2701","94474","13752","923","12818","11"
"2022-06-23T00:00:00.000","134","Stafford","1716","1555","161","14429","34","26","8","7477","62869","33796","2094","31668","34"
"2022-06-23T00:00:00.000","135","Stamford","31194","28789","2405","24062","385","337","48","130949","101011","494834","39875","454461","498"
"2022-06-23T00:00:00.000","136","Sterling","767","710","57","20280","3","3","0","2757","72898","10495","910","9574","11"
"2022-06-23T00:00:00.000","137","Stonington","3546","3204","342","19107","60","40","20","16609","89493","74788","4366","70361","61"
"2022-06-23T00:00:00.000","138","Stratford","13954","11948","2006","26913","201","166","35","48521","93581","227732","17416","210021","295"
"2022-06-23T00:00:00.000","139","Suffield","3656","3131","525","23119","51","39","12","14580","92197","117424","4484","112860","80"
"2022-06-23T00:00:00.000","140","Thomaston","1873","1577","296","24857","18","18","0","6352","84300","31274","2346","28900","28"
"2022-06-23T00:00:00.000","141","Thompson","1822","1718","104","19426","14","9","5","6596","70327","26503","2171","24290","42"
"2022-06-23T00:00:00.000","142","Tolland","2307","2071","236","15782","25","12","13","11651","79703","45822","2709","43065","48"
"2022-06-23T00:00:00.000","143","Torrington","7978","7550","428","23434","183","163","20","29467","86556","155831","9834","145737","260"
"2022-06-23T00:00:00.000","144","Trumbull","8916","7808","1108","24994","177","123","54","35599","99793","166609","11045","155339","225"
"2022-06-23T00:00:00.000","145","Union","217","200","17","25864","2","2","0","1088","129678","4358","251","4103","4"
"2022-06-23T00:00:00.000","146","Vernon","5051","4535","516","17204","78","52","26","22342","76099","91795","5897","85768","130"
"2022-06-23T00:00:00.000","147","Voluntown","527","492","35","20996","6","6","0","2121","84502","8415","624","7784","7"
"2022-06-23T00:00:00.000","148","Wallingford","10736","9575","1161","24221","217","187","30","40285","90883","234119","13225","220619","275"
"2022-06-23T00:00:00.000","149","Warren","157","115","42","11254","0","0","0","1033","74050","3839","179","3655","5"
"2022-06-23T00:00:00.000","150","Washington","538","444","94","15694","2","2","0","4007","116890","17906","614","17276","16"
"2022-06-23T00:00:00.000","151","Waterbury","33758","29509","4249","31383","503","442","61","106787","99274","545359","43546","500902","911"
"2022-06-23T00:00:00.000","152","Waterford","4477","4180","297","23882","77","57","20","18135","96741","87275","5392","81793","90"
"2022-06-23T00:00:00.000","153","Watertown","5219","4451","768","24187","78","71","7","19431","90050","95584","6653","88780","151"
"2022-06-23T00:00:00.000","154","Westbrook","1323","1241","82","19260","10","6","4","6199","90246","24190","1628","22534","28"
"2022-06-23T00:00:00.000","155","West Hartford","11766","10412","1354","18687","274","207","67","58869","93495","293811","14385","279127","299"
"2022-06-23T00:00:00.000","156","West Haven","13686","11947","1739","25057","164","149","15","49497","90621","242853","17071","225507","275"
"2022-06-23T00:00:00.000","157","Weston","1687","1532","155","16455","5","3","2","10336","100819","41099","2051","39015","33"
"2022-06-23T00:00:00.000","158","Westport","5224","4775","449","18336","37","27","10","30546","107213","144594","6366","138117","111"
"2022-06-23T00:00:00.000","159","Wethersfield","5962","5509","453","22924","55","46","9","22934","88181","107991","7351","100520","120"
"2022-06-23T00:00:00.000","160","Willington","812","730","82","13847","4","4","0","4122","70293","16411","932","15465","14"
"2022-06-23T00:00:00.000","161","Wilton","3252","2985","267","17729","55","29","26","18828","102644","72595","3898","68668","29"
"2022-06-23T00:00:00.000","162","Winchester","1836","1761","75","17314","16","16","0","8295","78225","33967","2164","31778","25"
"2022-06-23T00:00:00.000","163","Windham","6984","6558","426","28435","71","48","23","22382","91128","117600","8996","108458","146"
"2022-06-23T00:00:00.000","164","Windsor","7052","6448","604","24543","164","126","38","27217","94724","152754","8916","143674","164"
"2022-06-23T00:00:00.000","165","Windsor Locks","2698","2504","194","20990","44","40","4","10506","81733","44726","3343","41328","55"
"2022-06-23T00:00:00.000","166","Wolcott","4089","3557","532","24652","64","54","10","14323","86351","71384","5162","66117","105"
"2022-06-23T00:00:00.000","167","Woodbridge","1698","1518","180","19406","48","42","6","8665","99029","50532","2114","48347","71"
"2022-06-23T00:00:00.000","168","Woodbury","1643","1364","279","17291","12","10","2","7916","83309","34220","2019","32173","28"
"2022-06-23T00:00:00.000","169","Woodstock","1440","1391","49","18325","7","7","0","6739","85760","23639","1680","21930","29"
"2022-06-22T00:00:00.000","1","Andover","512","438","74","15822","6","4","2","2436","75278","9360","588","8764","8"
"2022-06-22T00:00:00.000","2","Ansonia","4900","4211","689","26268","49","39","10","16299","87375","76923","6034","70732","157"
"2022-06-22T00:00:00.000","3","Ashford","742","669","73","17438","5","4","1","3397","79835","13152","894","12245","13"
"2022-06-22T00:00:00.000","4","Avon","3015","2763","252","16497","81","65","16","17086","93489","74726","3543","71102","81"
"2022-06-22T00:00:00.000","5","Barkhamsted","525","490","35","14559","8","7","1","2698","74820","11001","619","10368","14"
"2022-06-22T00:00:00.000","6","Beacon Falls","1304","1161","143","20958","11","11","0","4902","78785","23179","1586","21548","45"
"2022-06-22T00:00:00.000","7","Berlin","4091","3745","346","20019","52","45","7","16523","80852","75185","4953","70149","83"
"2022-06-22T00:00:00.000","8","Bethany","990","900","90","17844","4","3","1","4651","83832","23338","1210","22097","31"
"2022-06-22T00:00:00.000","9","Bethel","4087","3342","745","20641","71","56","15","18097","91399","74441","4923","69435","83"
"2022-06-22T00:00:00.000","10","Bethlehem","618","528","90","18166","3","2","1","2784","81834","11830","748","11060","22"
"2022-06-22T00:00:00.000","11","Bloomfield","4954","4524","430","23356","136","116","20","20216","95309","133626","6213","127212","201"
"2022-06-22T00:00:00.000","12","Bolton","752","653","99","15397","5","4","1","3957","81020","14981","890","14080","11"
"2022-06-22T00:00:00.000","13","Bozrah","609","560","49","22340","7","7","0","2224","81585","10021","734","9278","9"
"2022-06-22T00:00:00.000","14","Branford","5930","5337","593","21254","82","73","9","25507","91423","124478","7139","117199","140"
"2022-06-22T00:00:00.000","15","Bridgeport","42706","38502","4204","29575","450","370","80","140072","97003","686506","54977","630449","1080"
"2022-06-22T00:00:00.000","16","Bridgewater","201","134","67","12294","0","0","0","1424","87095","5276","241","5029","6"
"2022-06-22T00:00:00.000","17","Bristol","14433","12407","2026","24076","211","172","39","52436","87471","272855","17874","254630","351"
"2022-06-22T00:00:00.000","18","Brookfield","3718","2981","737","21905","27","20","7","15820","93207","62703","4438","58205","60"
"2022-06-22T00:00:00.000","19","Brooklyn","2118","2007","111","25604","18","18","0","7570","91514","45709","2582","43099","28"
"2022-06-22T00:00:00.000","20","Burlington","1748","1496","252","18013","8","6","2","7900","81410","33549","2099","31412","38"
"2022-06-22T00:00:00.000","21","Canaan","28","27","1","2659","0","0","0","356","33808","1281","35","1246","0"
"2022-06-22T00:00:00.000","22","Canterbury","1132","1048","84","22288","4","4","0","4082","80370","17010","1352","15642","16"
"2022-06-22T00:00:00.000","23","Canton","1461","1316","145","14248","39","32","7","8262","80573","35033","1688","33319","26"
"2022-06-22T00:00:00.000","24","Chaplin","445","415","30","19875","3","3","0","1790","79946","7515","530","6983","2"
"2022-06-22T00:00:00.000","25","Cheshire","6354","5631","723","21958","80","66","14","26349","91056","166285","7623","158514","148"
"2022-06-22T00:00:00.000","26","Chester","613","559","54","14550","19","16","3","3513","83385","17234","765","16444","25"
"2022-06-22T00:00:00.000","27","Clinton","2645","2468","177","20464","15","10","5","11824","91482","49115","3207","45850","58"
"2022-06-22T00:00:00.000","28","Colchester","3140","2816","324","19862","42","29","13","13880","87798","63268","3802","59393","73"
"2022-06-22T00:00:00.000","29","Colebrook","146","137","9","10429","1","1","0","856","61143","3664","168","3492","4"
"2022-06-22T00:00:00.000","30","Columbia","974","860","114","18107","13","10","3","4480","83287","17957","1154","16788","15"
"2022-06-22T00:00:00.000","31","Cornwall","190","181","9","13950","2","0","2","1403","103010","5033","218","4812","3"
"2022-06-22T00:00:00.000","32","Coventry","2111","1827","284","17015","11","10","1","9934","80068","38443","2477","35925","41"
"2022-06-22T00:00:00.000","33","Cromwell","2962","2648","314","21403","66","42","24","12607","91098","66555","3635","62831","89"
"2022-06-22T00:00:00.000","34","Danbury","20986","18809","2177","24779","218","181","37","80826","95433","322561","25761","296306","494"
"2022-06-22T00:00:00.000","35","Darien","3882","3421","461","17866","13","12","1","22626","104133","91860","4713","87068","79"
"2022-06-22T00:00:00.000","36","Deep River","756","707","49","17016","1","1","0","3836","86338","15630","915","14695","20"
"2022-06-22T00:00:00.000","37","Derby","3121","2652","469","25294","30","24","6","10967","88881","50032","3821","46118","93"
"2022-06-22T00:00:00.000","38","Durham","1464","1327","137","20433","9","8","1","6186","86336","29816","1772","28016","28"
"2022-06-22T00:00:00.000","39","Eastford","279","266","13","15587","4","3","1","1222","68268","4466","332","4133","1"
"2022-06-22T00:00:00.000","40","East Granby","882","779","103","17160","4","2","2","4365","84922","18055","1081","16964","10"
"2022-06-22T00:00:00.000","41","East Haddam","1337","1160","177","14861","23","10","13","6796","75536","30486","1570","28889","27"
"2022-06-22T00:00:00.000","42","East Hampton","2345","2021","324","18320","25","18","7","10607","82867","45523","2814","42660","49"
"2022-06-22T00:00:00.000","43","East Hartford","13733","12478","1255","27536","198","155","43","44915","90061","227417","17348","209733","336"
"2022-06-22T00:00:00.000","44","East Haven","7623","6634","989","26683","107","87","20","25859","90514","126675","9367","117184","124"
"2022-06-22T00:00:00.000","45","East Lyme","3731","3449","282","20209","62","49","13","18019","97600","93865","4459","89349","57"
"2022-06-22T00:00:00.000","46","Easton","1408","1230","178","18721","5","4","1","7097","94362","26582","1717","24836","29"
"2022-06-22T00:00:00.000","47","East Windsor","2216","2001","215","18992","61","46","15","9266","79414","46771","2729","43978","64"
"2022-06-22T00:00:00.000","48","Ellington","2378","2160","218","14441","33","21","12","12196","74063","42632","2767","39816","49"
"2022-06-22T00:00:00.000","49","Enfield","9145","8270","875","20946","89","79","10","34800","79709","186335","11183","174874","278"
"2022-06-22T00:00:00.000","50","Essex","1062","977","85","15927","13","12","1","5885","88257","26928","1315","25589","24"
"2022-06-22T00:00:00.000","51","Fairfield","15119","13589","1530","24368","244","185","59","65648","105807","374017","18102","355515","400"
"2022-06-22T00:00:00.000","52","Farmington","4598","4054","544","18033","67","54","13","23458","92003","114122","5457","108519","146"
"2022-06-22T00:00:00.000","53","Franklin","435","409","26","22656","2","2","0","1492","77708","6877","530","6338","9"
"2022-06-22T00:00:00.000","54","Glastonbury","6137","5445","692","17798","119","98","21","30195","87567","126780","7485","119157","138"
"2022-06-22T00:00:00.000","55","Goshen","447","414","33","15613","2","2","0","2472","86343","9655","543","9103","9"
"2022-06-22T00:00:00.000","56","Granby","1551","1344","207","13479","33","28","5","8953","77805","35895","1842","34011","42"
"2022-06-22T00:00:00.000","57","Greenwich","14380","13381","999","22884","124","100","24","66374","105624","300610","17532","282853","225"
"2022-06-22T00:00:00.000","58","Griswold","2919","2662","257","25308","32","23","9","10220","88608","45011","3531","41446","34"
"2022-06-22T00:00:00.000","59","Groton","7925","7089","836","20619","122","78","44","33369","86817","148810","9552","139111","147"
"2022-06-22T00:00:00.000","60","Guilford","4353","3969","384","19667","45","35","10","20538","92794","100526","5154","95279","93"
"2022-06-22T00:00:00.000","61","Haddam","1422","1325","97","17356","11","6","5","6860","83730","29929","1719","28189","21"
"2022-06-22T00:00:00.000","62","Hamden","14141","12284","1857","23352","234","199","35","58735","96993","411295","17388","393488","419"
"2022-06-22T00:00:00.000","63","Hampton","465","440","25","25244","1","1","0","1887","102443","7829","551","7275","3"
"2022-06-22T00:00:00.000","64","Hartford","33814","31522","2292","27693","417","368","49","114898","94098","677580","42499","634145","936"
"2022-06-22T00:00:00.000","65","Hartland","246","223","23","11604","5","4","1","1328","62642","4982","297","4679","6"
"2022-06-22T00:00:00.000","66","Harwinton","1013","929","84","18690","9","6","3","4377","80756","18645","1219","17402","24"
"2022-06-22T00:00:00.000","67","Hebron","1560","1367","193","16414","15","11","4","7524","79167","30203","1870","28307","26"
"2022-06-22T00:00:00.000","68","Kent","555","504","51","19986","2","2","0","3876","139575","23971","669","23300","2"
"2022-06-22T00:00:00.000","69","Killingly","4541","4309","232","26194","80","57","23","15349","88538","68042","5501","62483","58"
"2022-06-22T00:00:00.000","70","Killingworth","1080","985","95","16970","11","6","5","5393","84742","23711","1264","22418","29"
"2022-06-22T00:00:00.000","71","Lebanon","1419","1302","117","19863","7","6","1","6021","84281","26189","1722","24450","17"
"2022-06-22T00:00:00.000","72","Ledyard","3342","3041","301","22858","14","13","1","13693","93653","57445","3948","53434","63"
"2022-06-22T00:00:00.000","73","Lisbon","899","820","79","21303","13","13","0","3135","74289","14308","1098","13185","25"
"2022-06-22T00:00:00.000","74","Litchfield","1293","1168","125","15975","13","11","2","6897","85211","29990","1524","28434","32"
"2022-06-22T00:00:00.000","75","Lyme","328","303","25","14162","1","0","1","1961","84672","7772","387","7381","4"
"2022-06-22T00:00:00.000","76","Madison","3399","3137","262","18852","46","36","10","17605","97643","83536","4048","79411","77"
"2022-06-22T00:00:00.000","77","Manchester","11810","10315","1495","20509","192","139","53","48793","84734","221962","14481","207213","268"
"2022-06-22T00:00:00.000","78","Mansfield","2966","2684","282","11637","32","27","5","17340","68035","97851","3409","94337","105"
"2022-06-22T00:00:00.000","79","Marlborough","1146","985","161","18090","31","22","9","5296","83599","26093","1416","24651","26"
"2022-06-22T00:00:00.000","80","Meriden","17347","15759","1588","29206","220","195","25","56122","94489","316174","21771","293966","437"
"2022-06-22T00:00:00.000","81","Middlebury","1628","1356","272","20877","23","18","5","7221","92601","35576","2037","33469","70"
"2022-06-22T00:00:00.000","82","Middlefield","713","638","75","16301","5","3","2","3670","83905","17057","920","16123","14"
"2022-06-22T00:00:00.000","83","Middletown","10990","10024","966","23758","184","136","48","43780","94643","463941","13801","449642","498"
"2022-06-22T00:00:00.000","84","Milford","12246","11072","1174","22368","184","160","24","46602","85122","221189","15116","205860","213"
"2022-06-22T00:00:00.000","85","Monroe","4152","3510","642","21365","25","17","8","17315","89096","70960","5013","65882","65"
"2022-06-22T00:00:00.000","86","Montville","4575","4213","362","24719","49","44","5","16968","91679","99542","5478","93953","111"
"2022-06-22T00:00:00.000","87","Morris","334","307","27","14818","3","3","0","1823","80878","7424","390","7028","6"
"2022-06-22T00:00:00.000","88","Naugatuck","8291","6896","1395","26652","141","123","18","27453","88251","151314","10588","140420","306"
"2022-06-22T00:00:00.000","89","New Britain","20414","18787","1627","28159","273","225","48","64269","88653","315794","25420","289885","489"
"2022-06-22T00:00:00.000","90","New Canaan","3637","3228","409","17976","44","38","6","21705","107275","86520","4329","82126","65"
"2022-06-22T00:00:00.000","91","New Fairfield","2587","2159","428","18641","9","6","3","11738","84580","41893","3042","38807","44"
"2022-06-22T00:00:00.000","92","New Hartford","1115","1038","77","16752","6","5","1","5251","78891","20717","1340","19358","19"
"2022-06-22T00:00:00.000","93","New Haven","35827","33193","2634","27506","289","256","33","128498","98655","927270","44594","881383","1293"
"2022-06-22T00:00:00.000","94","Newington","6745","6228","517","22473","138","117","21","26447","88116","129202","8374","120661","167"
"2022-06-22T00:00:00.000","95","New London","7987","7460","527","29738","50","44","6","30812","114722","337904","9789","327816","299"
"2022-06-22T00:00:00.000","96","New Milford","5276","3578","1698","19683","63","45","18","24039","89681","104541","6227","98171","143"
"2022-06-22T00:00:00.000","97","Newtown","5142","4254","888","18436","80","68","12","24643","88355","116436","6161","110183","92"
"2022-06-22T00:00:00.000","98","Norfolk","141","132","9","8650","1","1","0","793","48650","3471","164","3304","3"
"2022-06-22T00:00:00.000","99","North Branford","3208","2764","444","22678","29","15","14","11769","83197","56822","3856","52909","57"
"2022-06-22T00:00:00.000","100","North Canaan","549","530","19","16887","19","18","1","3094","95171","18055","626","17411","18"
"2022-06-22T00:00:00.000","101","North Haven","6023","4924","1099","25432","66","62","4","22278","94067","112741","7335","105306","100"
"2022-06-22T00:00:00.000","102","North Stonington","1011","926","85","19457","9","7","2","4009","77156","15603","1188","14404","11"
"2022-06-22T00:00:00.000","103","Norwalk","23375","21226","2149","26318","271","236","35","89618","100903","381180","29936","350826","418"
"2022-06-22T00:00:00.000","104","Norwich","10643","9509","1134","27453","102","87","15","36679","94612","167381","13236","153995","150"
"2022-06-22T00:00:00.000","105","Old Lyme","1326","1252","74","18149","4","3","1","7202","98577","28286","1610","26652","24"
"2022-06-22T00:00:00.000","106","Old Saybrook","2171","2023","148","21578","66","53","13","10192","101302","47517","2654","44821","42"
"2022-06-22T00:00:00.000","107","Orange","3018","2717","301","21672","24","21","3","12868","92403","55345","3590","51705","50"
"2022-06-22T00:00:00.000","108","Oxford","2530","2243","287","19087","33","32","1","10793","81426","45071","3093","41928","50"
"2022-06-22T00:00:00.000","109","Plainfield","3889","3599","290","25712","55","47","8","12673","83788","56399","4718","51653","28"
"2022-06-22T00:00:00.000","110","Plainville","3940","3367","573","22471","60","57","3","14558","83027","73329","4904","68332","93"
"2022-06-22T00:00:00.000","111","Plymouth","2402","2048","354","20710","19","16","3","9448","81462","45020","2956","42008","56"
"2022-06-22T00:00:00.000","112","Pomfret","819","727","92","19486","7","6","1","4435","105520","21872","989","20873","10"
"2022-06-22T00:00:00.000","113","Portland","1660","1509","151","17913","30","22","8","8047","86835","39955","2022","37897","36"
"2022-06-22T00:00:00.000","114","Preston","1094","991","103","23654","9","9","0","4111","88886","18461","1281","17153","27"
"2022-06-22T00:00:00.000","115","Prospect","2104","1811","293","21686","10","10","0","7905","81478","36815","2611","34153","51"
"2022-06-22T00:00:00.000","116","Putnam","2228","2127","101","23730","36","33","3","8159","86900","32122","2690","29405","27"
"2022-06-22T00:00:00.000","117","Redding","1418","1254","164","15555","22","18","4","8009","87857","32474","1755","30685","34"
"2022-06-22T00:00:00.000","118","Ridgefield","4389","3939","450","17585","69","52","17","23907","95785","99494","5361","94037","96"
"2022-06-22T00:00:00.000","119","Rocky Hill","4325","3847","478","21501","150","126","24","17263","85822","89699","5524","84043","132"
"2022-06-22T00:00:00.000","120","Roxbury","318","226","92","14777","2","0","2","1951","90660","6864","367","6494","3"
"2022-06-22T00:00:00.000","121","Salem","831","779","52","20353","5","5","0","3548","86897","14905","1026","13863","16"
"2022-06-22T00:00:00.000","122","Salisbury","549","489","60","15250","2","1","1","5148","143000","22838","651","22174","13"
"2022-06-22T00:00:00.000","123","Scotland","122","118","4","7297","2","2","0","483","28888","2033","149","1884","0"
"2022-06-22T00:00:00.000","124","Seymour","4005","3541","464","24366","83","68","15","14247","86676","70102","4870","65093","139"
"2022-06-22T00:00:00.000","125","Sharon","294","284","10","10933","4","3","1","2247","83563","9503","361","9139","3"
"2022-06-22T00:00:00.000","126","Shelton","9878","8611","1267","24017","212","169","43","37208","90467","173858","12152","161436","270"
"2022-06-22T00:00:00.000","127","Sherman","520","358","162","14325","3","0","3","3119","85923","10519","581","9919","19"
"2022-06-22T00:00:00.000","128","Simsbury","3678","3343","335","14483","34","29","5","22009","86667","94056","4311","89658","87"
"2022-06-22T00:00:00.000","129","Somers","2106","1941","165","19529","23","20","3","8338","77318","60053","2457","57518","78"
"2022-06-22T00:00:00.000","130","Southbury","3586","2907","679","18323","85","72","13","17158","87671","88212","4524","83592","96"
"2022-06-22T00:00:00.000","131","Southington","9263","7913","1350","21132","135","115","20","36419","83084","182593","11417","170962","214"
"2022-06-22T00:00:00.000","132","South Windsor","4631","4174","457","17701","67","44","23","21410","81836","80974","5441","75420","113"
"2022-06-22T00:00:00.000","133","Sprague","765","696","69","26758","6","5","1","2701","94474","13748","922","12815","11"
"2022-06-22T00:00:00.000","134","Stafford","1712","1553","159","14395","34","26","8","7470","62810","33787","2090","31663","34"
"2022-06-22T00:00:00.000","135","Stamford","31162","28760","2402","24038","385","337","48","130918","100987","494541","39836","454207","498"
"2022-06-22T00:00:00.000","136","Sterling","767","710","57","20280","3","3","0","2758","72924","10492","910","9571","11"
"2022-06-22T00:00:00.000","137","Stonington","3545","3203","342","19101","60","40","20","16611","89504","74738","4365","70312","61"
"2022-06-22T00:00:00.000","138","Stratford","13948","11942","2006","26901","201","166","35","48518","93576","227671","17409","209967","295"
"2022-06-22T00:00:00.000","139","Suffield","3654","3130","524","23106","51","39","12","14577","92178","117364","4482","112802","80"
"2022-06-22T00:00:00.000","140","Thomaston","1872","1576","296","24844","18","18","0","6350","84273","31253","2345","28880","28"
"2022-06-22T00:00:00.000","141","Thompson","1822","1718","104","19426","14","9","5","6595","70317","26478","2171","24265","42"
"2022-06-22T00:00:00.000","142","Tolland","2306","2070","236","15775","25","12","13","11648","79683","45803","2705","43050","48"
"2022-06-22T00:00:00.000","143","Torrington","7970","7547","423","23411","183","163","20","29469","86562","155742","9824","145659","259"
"2022-06-22T00:00:00.000","144","Trumbull","8910","7801","1109","24977","177","123","54","35588","99762","166441","11036","155181","224"
"2022-06-22T00:00:00.000","145","Union","217","200","17","25864","2","2","0","1088","129678","4354","251","4099","4"
"2022-06-22T00:00:00.000","146","Vernon","5047","4531","516","17191","78","52","26","22337","76082","91744","5892","85722","130"
"2022-06-22T00:00:00.000","147","Voluntown","527","492","35","20996","6","6","0","2121","84502","8410","624","7779","7"
"2022-06-22T00:00:00.000","148","Wallingford","10721","9562","1159","24187","217","187","30","40268","90845","234002","13207","220521","274"
"2022-06-22T00:00:00.000","149","Warren","157","115","42","11254","0","0","0","1032","73978","3839","179","3655","5"
"2022-06-22T00:00:00.000","150","Washington","538","444","94","15694","2","2","0","3995","116540","17875","614","17245","16"
"2022-06-22T00:00:00.000","151","Waterbury","33752","29505","4247","31377","503","442","61","106767","99255","545173","43534","500728","911"
"2022-06-22T00:00:00.000","152","Waterford","4475","4178","297","23872","77","57","20","18134","96735","87254","5390","81774","90"
"2022-06-22T00:00:00.000","153","Watertown","5217","4449","768","24177","78","71","7","19426","90027","95535","6649","88735","151"
"2022-06-22T00:00:00.000","154","Westbrook","1320","1238","82","19217","10","6","4","6192","90144","24196","1624","22544","28"
"2022-06-22T00:00:00.000","155","West Hartford","11746","10398","1348","18655","273","206","67","58849","93463","293639","14362","278980","297"
"2022-06-22T00:00:00.000","156","West Haven","13676","11939","1737","25038","164","149","15","49487","90602","242692","17054","225363","275"
"2022-06-22T00:00:00.000","157","Weston","1687","1532","155","16455","5","3","2","10335","100810","41062","2049","38980","33"
"2022-06-22T00:00:00.000","158","Westport","5214","4765","449","18301","37","27","10","30542","107199","144474","6355","138010","109"
"2022-06-22T00:00:00.000","159","Wethersfield","5953","5501","452","22889","55","46","9","22927","88154","107936","7340","100476","120"
"2022-06-22T00:00:00.000","160","Willington","811","729","82","13830","4","4","0","4121","70276","16421","931","15476","14"
"2022-06-22T00:00:00.000","161","Wilton","3243","2976","267","17680","55","29","26","18821","102606","72508","3886","68593","29"
"2022-06-22T00:00:00.000","162","Winchester","1836","1761","75","17314","16","16","0","8291","78187","33945","2164","31756","25"
"2022-06-22T00:00:00.000","163","Windham","6983","6557","426","28431","71","48","23","22381","91124","117444","8993","108305","146"
"2022-06-22T00:00:00.000","164","Windsor","7045","6444","601","24519","164","126","38","27207","94689","152632","8905","143564","163"
"2022-06-22T00:00:00.000","165","Windsor Locks","2694","2502","192","20958","44","40","4","10493","81632","44673","3337","41281","55"
"2022-06-22T00:00:00.000","166","Wolcott","4086","3554","532","24634","64","54","10","14327","86375","71347","5158","66084","105"
"2022-06-22T00:00:00.000","167","Woodbridge","1696","1517","179","19383","48","42","6","8664","99017","50494","2112","48311","71"
"2022-06-22T00:00:00.000","168","Woodbury","1642","1363","279","17281","12","10","2","7913","83277","34183","2018","32137","28"
"2022-06-22T00:00:00.000","169","Woodstock","1440","1391","49","18325","7","7","0","6738","85747","23632","1680","21923","29"
"2022-06-21T00:00:00.000","1","Andover","512","438","74","15822","6","4","2","2436","75278","9361","588","8765","8"
"2022-06-21T00:00:00.000","2","Ansonia","4898","4210","688","26257","49","39","10","16292","87338","76862","6030","70675","157"
"2022-06-21T00:00:00.000","3","Ashford","742","669","73","17438","5","4","1","3396","79812","13142","894","12235","13"
"2022-06-21T00:00:00.000","4","Avon","3010","2762","248","16470","81","65","16","17082","93467","74677","3537","71059","81"
"2022-06-21T00:00:00.000","5","Barkhamsted","524","489","35","14531","8","7","1","2695","74737","10993","618","10361","14"
"2022-06-21T00:00:00.000","6","Beacon Falls","1302","1158","144","20926","11","11","0","4901","78769","23181","1581","21555","45"
"2022-06-21T00:00:00.000","7","Berlin","4088","3743","345","20004","52","45","7","16516","80818","75134","4949","70102","83"
"2022-06-21T00:00:00.000","8","Bethany","989","899","90","17826","4","3","1","4654","83886","23326","1208","22087","31"
"2022-06-21T00:00:00.000","9","Bethel","4082","3340","742","20616","71","56","15","18094","91384","74411","4917","69411","83"
"2022-06-21T00:00:00.000","10","Bethlehem","618","528","90","18166","3","2","1","2783","81805","11822","747","11053","22"
"2022-06-21T00:00:00.000","11","Bloomfield","4948","4521","427","23328","136","116","20","20205","95257","133567","6206","127160","201"
"2022-06-21T00:00:00.000","12","Bolton","752","653","99","15397","5","4","1","3956","80999","14974","890","14073","11"
"2022-06-21T00:00:00.000","13","Bozrah","609","560","49","22340","7","7","0","2225","81621","10024","734","9281","9"
"2022-06-21T00:00:00.000","14","Branford","5932","5339","593","21262","82","73","9","25506","91419","124383","7136","117107","140"
"2022-06-21T00:00:00.000","15","Bridgeport","42674","38471","4203","29553","450","370","80","140037","96979","686041","54940","630023","1078"
"2022-06-21T00:00:00.000","16","Bridgewater","201","134","67","12294","0","0","0","1423","87034","5269","241","5022","6"
"2022-06-21T00:00:00.000","17","Bristol","14425","12401","2024","24063","211","172","39","52416","87437","272669","17865","254455","349"
"2022-06-21T00:00:00.000","18","Brookfield","3715","2977","738","21888","27","20","7","15820","93207","62648","4435","58153","60"
"2022-06-21T00:00:00.000","19","Brooklyn","2117","2007","110","25592","18","18","0","7569","91501","45667","2582","43057","28"
"2022-06-21T00:00:00.000","20","Burlington","1746","1495","251","17993","8","6","2","7895","81358","33545","2098","31409","38"
"2022-06-21T00:00:00.000","21","Canaan","29","28","1","2754","0","0","0","357","33903","1281","36","1245","0"
"2022-06-21T00:00:00.000","22","Canterbury","1131","1048","83","22268","4","4","0","4080","80331","16986","1351","15619","16"
"2022-06-21T00:00:00.000","23","Canton","1460","1317","143","14238","39","32","7","8263","80583","35020","1687","33307","26"
"2022-06-21T00:00:00.000","24","Chaplin","445","415","30","19875","3","3","0","1790","79946","7503","527","6974","2"
"2022-06-21T00:00:00.000","25","Cheshire","6348","5626","722","21937","80","66","14","26340","91025","166262","7614","158500","148"
"2022-06-21T00:00:00.000","26","Chester","613","559","54","14550","19","16","3","3512","83361","17231","765","16441","25"
"2022-06-21T00:00:00.000","27","Clinton","2645","2468","177","20464","15","10","5","11823","91474","49054","3200","45796","58"
"2022-06-21T00:00:00.000","28","Colchester","3137","2814","323","19843","42","29","13","13877","87779","63246","3799","59374","73"
"2022-06-21T00:00:00.000","29","Colebrook","145","136","9","10357","1","1","0","856","61143","3663","167","3492","4"
"2022-06-21T00:00:00.000","30","Columbia","973","860","113","18089","13","10","3","4475","83194","17962","1153","16794","15"
"2022-06-21T00:00:00.000","31","Cornwall","190","181","9","13950","2","0","2","1403","103010","5031","218","4810","3"
"2022-06-21T00:00:00.000","32","Coventry","2110","1826","284","17007","11","10","1","9933","80060","38436","2476","35919","41"
"2022-06-21T00:00:00.000","33","Cromwell","2961","2647","314","21396","66","42","24","12607","91098","66554","3633","62832","89"
"2022-06-21T00:00:00.000","34","Danbury","20975","18802","2173","24766","218","181","37","80817","95422","322432","25750","296188","494"
"2022-06-21T00:00:00.000","35","Darien","3866","3407","459","17793","13","12","1","22626","104133","91800","4695","87026","79"
"2022-06-21T00:00:00.000","36","Deep River","756","707","49","17016","1","1","0","3834","86293","15628","915","14693","20"
"2022-06-21T00:00:00.000","37","Derby","3117","2648","469","25261","30","24","6","10964","88856","50008","3816","46099","93"
"2022-06-21T00:00:00.000","38","Durham","1464","1327","137","20433","9","8","1","6179","86239","29771","1773","27970","28"
"2022-06-21T00:00:00.000","39","Eastford","279","266","13","15587","4","3","1","1221","68212","4460","332","4127","1"
"2022-06-21T00:00:00.000","40","East Granby","881","778","103","17140","4","2","2","4364","84903","18044","1080","16954","10"
"2022-06-21T00:00:00.000","41","East Haddam","1337","1160","177","14861","23","10","13","6796","75536","30481","1571","28883","27"
"2022-06-21T00:00:00.000","42","East Hampton","2344","2021","323","18312","25","18","7","10604","82844","45480","2812","42619","49"
"2022-06-21T00:00:00.000","43","East Hartford","13722","12470","1252","27514","198","155","43","44900","90030","227297","17339","209622","336"
"2022-06-21T00:00:00.000","44","East Haven","7619","6630","989","26669","107","87","20","25843","90458","126570","9367","117079","124"
"2022-06-21T00:00:00.000","45","East Lyme","3725","3443","282","20177","62","49","13","18017","97590","93799","4452","89290","57"
"2022-06-21T00:00:00.000","46","Easton","1406","1229","177","18694","5","4","1","7094","94323","26555","1715","24811","29"
"2022-06-21T00:00:00.000","47","East Windsor","2215","2000","215","18984","61","46","15","9259","79354","46742","2728","43950","64"
"2022-06-21T00:00:00.000","48","Ellington","2377","2159","218","14435","33","21","12","12191","74033","42595","2766","39780","49"
"2022-06-21T00:00:00.000","49","Enfield","9141","8269","872","20937","89","79","10","34799","79706","186205","11175","174752","278"
"2022-06-21T00:00:00.000","50","Essex","1061","977","84","15912","13","12","1","5882","88212","26840","1314","25502","24"
"2022-06-21T00:00:00.000","51","Fairfield","15110","13580","1530","24353","244","185","59","65629","105776","373855","18087","355368","400"
"2022-06-21T00:00:00.000","52","Farmington","4587","4046","541","17990","67","54","13","23457","91999","114114","5444","108524","146"
"2022-06-21T00:00:00.000","53","Franklin","434","408","26","22604","2","2","0","1491","77656","6864","529","6326","9"
"2022-06-21T00:00:00.000","54","Glastonbury","6127","5438","689","17769","119","98","21","30196","87570","126713","7473","119102","138"
"2022-06-21T00:00:00.000","55","Goshen","446","413","33","15578","2","2","0","2473","86378","9644","542","9093","9"
"2022-06-21T00:00:00.000","56","Granby","1546","1342","204","13435","33","28","5","8949","77770","35869","1838","33989","42"
"2022-06-21T00:00:00.000","57","Greenwich","14354","13355","999","22842","124","100","24","66353","105590","300366","17495","282646","225"
"2022-06-21T00:00:00.000","58","Griswold","2917","2660","257","25290","32","23","9","10214","88556","44996","3529","41433","34"
"2022-06-21T00:00:00.000","59","Groton","7914","7078","836","20590","122","78","44","33347","86760","148695","9539","139009","147"
"2022-06-21T00:00:00.000","60","Guilford","4345","3961","384","19631","45","35","10","20528","92748","100410","5145","95173","92"
"2022-06-21T00:00:00.000","61","Haddam","1422","1325","97","17356","11","6","5","6857","83693","29906","1720","28165","21"
"2022-06-21T00:00:00.000","62","Hamden","14122","12265","1857","23321","234","199","35","58721","96970","411027","17366","393242","419"
"2022-06-21T00:00:00.000","63","Hampton","465","440","25","25244","1","1","0","1885","102334","7823","551","7269","3"
"2022-06-21T00:00:00.000","64","Hartford","33798","31507","2291","27679","417","368","49","114859","94066","677240","42467","633837","936"
"2022-06-21T00:00:00.000","65","Hartland","246","223","23","11604","5","4","1","1328","62642","4983","297","4680","6"
"2022-06-21T00:00:00.000","66","Harwinton","1012","929","83","18672","9","6","3","4375","80720","18640","1218","17398","24"
"2022-06-21T00:00:00.000","67","Hebron","1558","1366","192","16393","15","11","4","7524","79167","30186","1868","28292","26"
"2022-06-21T00:00:00.000","68","Kent","555","504","51","19986","2","2","0","3881","139755","23985","669","23314","2"
"2022-06-21T00:00:00.000","69","Killingly","4543","4311","232","26206","80","57","23","15347","88527","68029","5502","62469","58"
"2022-06-21T00:00:00.000","70","Killingworth","1079","984","95","16955","11","6","5","5388","84664","23680","1263","22388","29"
"2022-06-21T00:00:00.000","71","Lebanon","1419","1303","116","19863","7","6","1","6020","84267","26163","1722","24424","17"
"2022-06-21T00:00:00.000","72","Ledyard","3337","3036","301","22823","14","13","1","13692","93646","57406","3940","53403","63"
"2022-06-21T00:00:00.000","73","Lisbon","899","820","79","21303","13","13","0","3138","74360","14288","1098","13165","25"
"2022-06-21T00:00:00.000","74","Litchfield","1290","1166","124","15938","13","11","2","6897","85211","29976","1520","28424","32"
"2022-06-21T00:00:00.000","75","Lyme","328","303","25","14162","1","0","1","1961","84672","7751","387","7360","4"
"2022-06-21T00:00:00.000","76","Madison","3391","3130","261","18808","46","36","10","17595","97587","83463","4039","79347","77"
"2022-06-21T00:00:00.000","77","Manchester","11798","10306","1492","20488","192","139","53","48780","84711","221872","14468","207137","267"
"2022-06-21T00:00:00.000","78","Mansfield","2962","2680","282","11622","32","27","5","17341","68039","97818","3402","94311","105"
"2022-06-21T00:00:00.000","79","Marlborough","1146","985","161","18090","31","22","9","5293","83552","26083","1416","24641","26"
"2022-06-21T00:00:00.000","80","Meriden","17333","15746","1587","29183","220","195","25","56107","94464","315935","21750","293748","437"
"2022-06-21T00:00:00.000","81","Middlebury","1627","1355","272","20864","23","18","5","7220","92588","35543","2037","33436","70"
"2022-06-21T00:00:00.000","82","Middlefield","713","638","75","16301","5","3","2","3668","83859","17050","920","16116","14"
"2022-06-21T00:00:00.000","83","Middletown","10981","10015","966","23739","184","136","48","43773","94628","463778","13788","449492","498"
"2022-06-21T00:00:00.000","84","Milford","12230","11056","1174","22339","184","160","24","46577","85077","221045","15099","205733","213"
"2022-06-21T00:00:00.000","85","Monroe","4150","3508","642","21354","25","17","8","17306","89050","70929","5010","65854","65"
"2022-06-21T00:00:00.000","86","Montville","4570","4208","362","24692","49","44","5","16966","91668","99486","5474","93901","111"
"2022-06-21T00:00:00.000","87","Morris","335","308","27","14862","3","3","0","1821","80790","7419","391","7022","6"
"2022-06-21T00:00:00.000","88","Naugatuck","8291","6896","1395","26652","141","123","18","27449","88238","151312","10586","140420","306"
"2022-06-21T00:00:00.000","89","New Britain","20411","18786","1625","28155","273","225","48","64258","88638","315643","25419","289735","489"
"2022-06-21T00:00:00.000","90","New Canaan","3632","3223","409","17951","44","38","6","21701","107255","86457","4323","82069","65"
"2022-06-21T00:00:00.000","91","New Fairfield","2583","2156","427","18612","9","6","3","11732","84537","41855","3037","38774","44"
"2022-06-21T00:00:00.000","92","New Hartford","1114","1037","77","16737","6","5","1","5247","78831","20704","1339","19346","19"
"2022-06-21T00:00:00.000","93","New Haven","35778","33146","2632","27469","289","256","33","128443","98613","926564","44534","880739","1291"
"2022-06-21T00:00:00.000","94","Newington","6741","6226","515","22460","138","117","21","26447","88116","129135","8366","120602","167"
"2022-06-21T00:00:00.000","95","New London","7981","7455","526","29716","50","44","6","30815","114733","337851","9783","327769","299"
"2022-06-21T00:00:00.000","96","New Milford","5275","3577","1698","19679","63","45","18","24036","89670","104554","6226","98185","143"
"2022-06-21T00:00:00.000","97","Newtown","5134","4248","886","18407","80","68","12","24637","88333","116415","6155","110168","92"
"2022-06-21T00:00:00.000","98","Norfolk","141","132","9","8650","1","1","0","794","48712","3471","164","3304","3"
"2022-06-21T00:00:00.000","99","North Branford","3200","2756","444","22621","29","15","14","11766","83175","56765","3846","52862","57"
"2022-06-21T00:00:00.000","100","North Canaan","549","530","19","16887","19","18","1","3094","95171","18053","626","17409","18"
"2022-06-21T00:00:00.000","101","North Haven","6020","4922","1098","25419","65","61","4","22272","94042","112651","7331","105220","100"
"2022-06-21T00:00:00.000","102","North Stonington","1011","926","85","19457","9","7","2","4008","77136","15596","1188","14397","11"
"2022-06-21T00:00:00.000","103","Norwalk","23356","21211","2145","26297","271","236","35","89611","100895","380986","29909","350659","418"
"2022-06-21T00:00:00.000","104","Norwich","10637","9504","1133","27438","103","87","16","36672","94593","167274","13222","153903","149"
"2022-06-21T00:00:00.000","105","Old Lyme","1324","1250","74","18122","4","3","1","7200","98549","28287","1608","26655","24"
"2022-06-21T00:00:00.000","106","Old Saybrook","2167","2019","148","21539","66","53","13","10183","101213","47493","2650","44801","42"
"2022-06-21T00:00:00.000","107","Orange","3012","2711","301","21629","24","21","3","12864","92374","55309","3583","51676","50"
"2022-06-21T00:00:00.000","108","Oxford","2527","2241","286","19065","33","32","1","10779","81320","45034","3086","41898","50"
"2022-06-21T00:00:00.000","109","Plainfield","3884","3597","287","25679","55","47","8","12669","83762","56372","4713","51631","28"
"2022-06-21T00:00:00.000","110","Plainville","3939","3366","573","22465","60","57","3","14548","82970","73274","4903","68278","93"
"2022-06-21T00:00:00.000","111","Plymouth","2403","2049","354","20719","19","16","3","9457","81540","45017","2957","42004","56"
"2022-06-21T00:00:00.000","112","Pomfret","819","727","92","19486","7","6","1","4436","105544","21874","988","20876","10"
"2022-06-21T00:00:00.000","113","Portland","1661","1510","151","17924","30","22","8","8044","86803","39950","2023","37891","36"
"2022-06-21T00:00:00.000","114","Preston","1094","991","103","23654","9","9","0","4109","88843","18440","1281","17132","27"
"2022-06-21T00:00:00.000","115","Prospect","2102","1808","294","21666","10","10","0","7901","81437","36785","2608","34126","51"
"2022-06-21T00:00:00.000","116","Putnam","2228","2127","101","23730","36","33","3","8157","86878","32100","2690","29383","27"
"2022-06-21T00:00:00.000","117","Redding","1414","1251","163","15511","22","18","4","8003","87791","32464","1751","30679","34"
"2022-06-21T00:00:00.000","118","Ridgefield","4381","3931","450","17553","69","52","17","23897","95745","99446","5355","93996","95"
"2022-06-21T00:00:00.000","119","Rocky Hill","4314","3837","477","21447","150","126","24","17264","85826","89686","5511","84047","128"
"2022-06-21T00:00:00.000","120","Roxbury","318","226","92","14777","2","0","2","1950","90613","6848","367","6478","3"
"2022-06-21T00:00:00.000","121","Salem","827","775","52","20255","5","5","0","3546","86848","14893","1022","13855","16"
"2022-06-21T00:00:00.000","122","Salisbury","549","489","60","15250","2","1","1","5148","143000","22844","651","22180","13"
"2022-06-21T00:00:00.000","123","Scotland","122","118","4","7297","2","2","0","483","28888","2031","149","1882","0"
"2022-06-21T00:00:00.000","124","Seymour","4002","3537","465","24348","83","68","15","14245","86664","70039","4864","65036","139"
"2022-06-21T00:00:00.000","125","Sharon","294","284","10","10933","4","3","1","2242","83377","9493","361","9129","3"
"2022-06-21T00:00:00.000","126","Shelton","9874","8608","1266","24007","212","169","43","37212","90476","173702","12144","161288","270"
"2022-06-21T00:00:00.000","127","Sherman","520","358","162","14325","3","0","3","3119","85923","10518","581","9918","19"
"2022-06-21T00:00:00.000","128","Simsbury","3672","3338","334","14460","34","29","5","22005","86651","94014","4304","89623","87"
"2022-06-21T00:00:00.000","129","Somers","2106","1941","165","19529","23","20","3","8341","77346","60058","2458","57522","78"
"2022-06-21T00:00:00.000","130","Southbury","3582","2903","679","18303","85","72","13","17158","87671","88143","4521","83526","96"
"2022-06-21T00:00:00.000","131","Southington","9255","7908","1347","21114","135","115","20","36415","83075","182503","11406","170883","214"
"2022-06-21T00:00:00.000","132","South Windsor","4623","4168","455","17671","67","44","23","21404","81813","80913","5432","75368","113"
"2022-06-21T00:00:00.000","133","Sprague","765","696","69","26758","6","5","1","2702","94509","13751","922","12818","11"
"2022-06-21T00:00:00.000","134","Stafford","1710","1551","159","14378","34","26","8","7470","62810","33766","2087","31645","34"
"2022-06-21T00:00:00.000","135","Stamford","31130","28731","2399","24013","385","337","48","130865","100946","494240","39801","453941","498"
"2022-06-21T00:00:00.000","136","Sterling","767","710","57","20280","3","3","0","2755","72845","10484","910","9563","11"
"2022-06-21T00:00:00.000","137","Stonington","3543","3202","341","19090","60","40","20","16606","89477","74682","4363","70258","61"
"2022-06-21T00:00:00.000","138","Stratford","13939","11933","2006","26884","201","166","35","48505","93551","227424","17390","209739","295"
"2022-06-21T00:00:00.000","139","Suffield","3648","3126","522","23068","51","39","12","14572","92146","117397","4475","112842","80"
"2022-06-21T00:00:00.000","140","Thomaston","1871","1575","296","24831","18","18","0","6347","84234","31245","2345","28872","28"
"2022-06-21T00:00:00.000","141","Thompson","1822","1718","104","19426","14","9","5","6593","70295","26468","2171","24255","42"
"2022-06-21T00:00:00.000","142","Tolland","2303","2067","236","15755","25","12","13","11645","79662","45764","2702","43014","48"
"2022-06-21T00:00:00.000","143","Torrington","7959","7539","420","23379","183","163","20","29448","86500","155651","9808","145584","259"
"2022-06-21T00:00:00.000","144","Trumbull","8890","7781","1109","24921","177","123","54","35580","99739","166317","11011","155081","225"
"2022-06-21T00:00:00.000","145","Union","217","200","17","25864","2","2","0","1087","129559","4351","252","4095","4"
"2022-06-21T00:00:00.000","146","Vernon","5044","4530","514","17180","78","52","26","22338","76086","91700","5887","85683","130"
"2022-06-21T00:00:00.000","147","Voluntown","527","492","35","20996","6","6","0","2121","84502","8401","624","7770","7"
"2022-06-21T00:00:00.000","148","Wallingford","10713","9557","1156","24169","217","187","30","40257","90820","233868","13198","220398","272"
"2022-06-21T00:00:00.000","149","Warren","157","115","42","11254","0","0","0","1032","73978","3837","179","3653","5"
"2022-06-21T00:00:00.000","150","Washington","538","444","94","15694","2","2","0","3997","116599","17874","613","17245","16"
"2022-06-21T00:00:00.000","151","Waterbury","33736","29491","4245","31362","503","442","61","106746","99236","544948","43509","500527","912"
"2022-06-21T00:00:00.000","152","Waterford","4469","4174","295","23840","76","57","19","18127","96698","87183","5382","81711","90"
"2022-06-21T00:00:00.000","153","Watertown","5215","4447","768","24168","78","71","7","19422","90008","95495","6646","88698","151"
"2022-06-21T00:00:00.000","154","Westbrook","1317","1235","82","19173","10","6","4","6191","90130","24183","1621","22534","28"
"2022-06-21T00:00:00.000","155","West Hartford","11736","10391","1345","18639","273","206","67","58828","93430","293507","14346","278864","297"
"2022-06-21T00:00:00.000","156","West Haven","13670","11931","1739","25027","164","149","15","49480","90590","242546","17043","225228","275"
"2022-06-21T00:00:00.000","157","Weston","1686","1531","155","16446","5","3","2","10330","100761","41029","2046","38950","33"
"2022-06-21T00:00:00.000","158","Westport","5207","4759","448","18276","37","27","10","30532","107164","144348","6348","137891","109"
"2022-06-21T00:00:00.000","159","Wethersfield","5949","5499","450","22874","55","46","9","22918","88119","107858","7334","100404","120"
"2022-06-21T00:00:00.000","160","Willington","810","728","82","13813","4","4","0","4118","70225","16402","930","15458","14"
"2022-06-21T00:00:00.000","161","Wilton","3236","2972","264","17642","55","29","26","18810","102546","72472","3878","68565","29"
"2022-06-21T00:00:00.000","162","Winchester","1837","1762","75","17324","16","16","0","8293","78206","33931","2165","31741","25"
"2022-06-21T00:00:00.000","163","Windham","6977","6551","426","28407","71","48","23","22368","91071","117182","8986","108050","146"
"2022-06-21T00:00:00.000","164","Windsor","7030","6437","593","24467","164","126","38","27193","94640","152544","8884","143497","163"
"2022-06-21T00:00:00.000","165","Windsor Locks","2691","2499","192","20935","44","40","4","10491","81617","44665","3336","41274","55"
"2022-06-21T00:00:00.000","166","Wolcott","4084","3553","531","24622","64","54","10","14320","86333","71317","5156","66056","105"
"2022-06-21T00:00:00.000","167","Woodbridge","1696","1517","179","19383","48","42","6","8662","98994","50397","2112","48214","71"
"2022-06-21T00:00:00.000","168","Woodbury","1640","1361","279","17260","12","10","2","7910","83246","34173","2014","32131","28"
"2022-06-21T00:00:00.000","169","Woodstock","1440","1391","49","18325","7","7","0","6739","85760","23634","1680","21925","29"
"2022-06-20T00:00:00.000","1","Andover","511","437","74","15791","6","4","2","2435","75247","9348","587","8753","8"
"2022-06-20T00:00:00.000","2","Ansonia","4892","4204","688","26225","49","39","10","16287","87311","76807","6023","70627","157"
"2022-06-20T00:00:00.000","3","Ashford","741","668","73","17415","5","4","1","3396","79812","13137","893","12231","13"
"2022-06-20T00:00:00.000","4","Avon","3005","2760","245","16442","81","65","16","17077","93439","74617","3530","71006","81"
"2022-06-20T00:00:00.000","5","Barkhamsted","524","489","35","14531","8","7","1","2696","74764","10999","618","10367","14"
"2022-06-20T00:00:00.000","6","Beacon Falls","1302","1158","144","20926","11","11","0","4902","78785","23170","1580","21545","45"
"2022-06-20T00:00:00.000","7","Berlin","4087","3742","345","19999","52","45","7","16515","80813","75135","4947","70105","83"
"2022-06-20T00:00:00.000","8","Bethany","990","900","90","17844","4","3","1","4656","83922","23324","1209","22084","31"
"2022-06-20T00:00:00.000","9","Bethel","4080","3338","742","20606","71","56","15","18096","91394","74395","4915","69397","83"
"2022-06-20T00:00:00.000","10","Bethlehem","617","527","90","18136","3","2","1","2784","81834","11822","746","11054","22"
"2022-06-20T00:00:00.000","11","Bloomfield","4936","4513","423","23271","136","116","20","20190","95186","133478","6186","127091","201"
"2022-06-20T00:00:00.000","12","Bolton","751","653","98","15377","5","4","1","3954","80958","14971","889","14071","11"
"2022-06-20T00:00:00.000","13","Bozrah","609","560","49","22340","7","7","0","2225","81621","10013","733","9271","9"
"2022-06-20T00:00:00.000","14","Branford","5923","5330","593","21229","82","73","9","25494","91376","124265","7126","116999","140"
"2022-06-20T00:00:00.000","15","Bridgeport","42652","38453","4199","29538","450","370","80","140016","96965","685762","54904","629779","1079"
"2022-06-20T00:00:00.000","16","Bridgewater","201","134","67","12294","0","0","0","1424","87095","5264","241","5017","6"
"2022-06-20T00:00:00.000","17","Bristol","14422","12402","2020","24058","210","171","39","52422","87447","272598","17857","254391","350"
"2022-06-20T00:00:00.000","18","Brookfield","3713","2974","739","21876","27","20","7","15816","93183","62621","4431","58130","60"
"2022-06-20T00:00:00.000","19","Brooklyn","2117","2007","110","25592","18","18","0","7568","91489","45686","2580","43078","28"
"2022-06-20T00:00:00.000","20","Burlington","1745","1494","251","17982","8","6","2","7896","81369","33513","2097","31378","38"
"2022-06-20T00:00:00.000","21","Canaan","28","27","1","2659","0","0","0","356","33808","1281","35","1246","0"
"2022-06-20T00:00:00.000","22","Canterbury","1131","1048","83","22268","4","4","0","4078","80291","16997","1351","15630","16"
"2022-06-20T00:00:00.000","23","Canton","1455","1314","141","14190","39","32","7","8258","80534","35003","1681","33296","26"
"2022-06-20T00:00:00.000","24","Chaplin","444","414","30","19830","3","3","0","1791","79991","7500","525","6973","2"
"2022-06-20T00:00:00.000","25","Cheshire","6342","5624","718","21917","80","66","14","26342","91032","166198","7607","158443","148"
"2022-06-20T00:00:00.000","26","Chester","613","559","54","14550","19","16","3","3510","83314","17226","765","16436","25"
"2022-06-20T00:00:00.000","27","Clinton","2640","2463","177","20426","14","9","5","11823","91474","49034","3195","45781","58"
"2022-06-20T00:00:00.000","28","Colchester","3135","2812","323","19830","42","29","13","13870","87735","63216","3795","59348","73"
"2022-06-20T00:00:00.000","29","Colebrook","145","136","9","10357","1","1","0","856","61143","3662","167","3491","4"
"2022-06-20T00:00:00.000","30","Columbia","971","859","112","18052","12","9","3","4472","83138","17956","1151","16790","15"
"2022-06-20T00:00:00.000","31","Cornwall","190","181","9","13950","2","0","2","1404","103084","5034","218","4813","3"
"2022-06-20T00:00:00.000","32","Coventry","2109","1825","284","16998","11","10","1","9926","80003","38415","2475","35899","41"
"2022-06-20T00:00:00.000","33","Cromwell","2962","2648","314","21403","66","42","24","12606","91090","66524","3634","62801","89"
"2022-06-20T00:00:00.000","34","Danbury","20962","18789","2173","24750","218","181","37","80787","95387","322306","25738","296074","494"
"2022-06-20T00:00:00.000","35","Darien","3866","3407","459","17793","13","12","1","22623","104119","91776","4693","87004","79"
"2022-06-20T00:00:00.000","36","Deep River","756","707","49","17016","1","1","0","3837","86361","15621","914","14687","20"
"2022-06-20T00:00:00.000","37","Derby","3117","2649","468","25261","30","24","6","10965","88865","49981","3815","46073","93"
"2022-06-20T00:00:00.000","38","Durham","1463","1326","137","20419","9","8","1","6179","86239","29774","1770","27976","28"
"2022-06-20T00:00:00.000","39","Eastford","279","266","13","15587","4","3","1","1220","68156","4459","332","4126","1"
"2022-06-20T00:00:00.000","40","East Granby","878","776","102","17082","4","2","2","4363","84883","18033","1077","16946","10"
"2022-06-20T00:00:00.000","41","East Haddam","1337","1159","178","14861","23","10","13","6792","75492","30459","1570","28862","27"
"2022-06-20T00:00:00.000","42","East Hampton","2342","2020","322","18297","25","18","7","10600","82812","45461","2810","42602","49"
"2022-06-20T00:00:00.000","43","East Hartford","13718","12467","1251","27506","198","155","43","44899","90028","227202","17333","209533","336"
"2022-06-20T00:00:00.000","44","East Haven","7612","6623","989","26644","107","87","20","25851","90486","126532","9357","117051","124"
"2022-06-20T00:00:00.000","45","East Lyme","3722","3440","282","20160","61","48","13","18014","97573","93758","4447","89254","57"
"2022-06-20T00:00:00.000","46","Easton","1406","1229","177","18694","5","4","1","7093","94309","26551","1715","24807","29"
"2022-06-20T00:00:00.000","47","East Windsor","2215","2000","215","18984","61","46","15","9258","79345","46741","2728","43949","64"
"2022-06-20T00:00:00.000","48","Ellington","2375","2157","218","14423","33","21","12","12189","74021","42574","2763","39762","49"
"2022-06-20T00:00:00.000","49","Enfield","9132","8264","868","20917","89","79","10","34781","79665","186119","11165","174676","278"
"2022-06-20T00:00:00.000","50","Essex","1061","977","84","15912","13","12","1","5880","88182","26827","1314","25489","24"
"2022-06-20T00:00:00.000","51","Fairfield","15097","13569","1528","24332","244","185","59","65618","105759","373682","18073","355209","400"
"2022-06-20T00:00:00.000","52","Farmington","4576","4038","538","17947","67","54","13","23432","91901","113964","5431","108387","146"
"2022-06-20T00:00:00.000","53","Franklin","434","408","26","22604","2","2","0","1491","77656","6870","528","6333","9"
"2022-06-20T00:00:00.000","54","Glastonbury","6118","5436","682","17743","118","97","21","30184","87536","126625","7463","119024","138"
"2022-06-20T00:00:00.000","55","Goshen","446","413","33","15578","2","2","0","2473","86378","9639","542","9088","9"
"2022-06-20T00:00:00.000","56","Granby","1544","1342","202","13418","33","28","5","8949","77770","35861","1836","33983","42"
"2022-06-20T00:00:00.000","57","Greenwich","14337","13341","996","22815","124","100","24","66336","105563","300226","17475","282526","225"
"2022-06-20T00:00:00.000","58","Griswold","2917","2660","257","25290","32","23","9","10213","88547","44954","3529","41391","34"
"2022-06-20T00:00:00.000","59","Groton","7917","7081","836","20598","122","78","44","33348","86762","148640","9541","138952","147"
"2022-06-20T00:00:00.000","60","Guilford","4340","3957","383","19609","44","35","9","20523","92726","100383","5142","95149","92"
"2022-06-20T00:00:00.000","61","Haddam","1421","1324","97","17344","11","6","5","6860","83730","29907","1718","28168","21"
"2022-06-20T00:00:00.000","62","Hamden","14119","12265","1854","23316","234","199","35","58706","96945","410948","17360","393170","418"
"2022-06-20T00:00:00.000","63","Hampton","465","440","25","25244","1","1","0","1888","102497","7823","551","7269","3"
"2022-06-20T00:00:00.000","64","Hartford","33789","31504","2285","27672","417","368","49","114833","94044","676999","42451","633612","936"
"2022-06-20T00:00:00.000","65","Hartland","246","223","23","11604","5","4","1","1328","62642","4980","297","4677","6"
"2022-06-20T00:00:00.000","66","Harwinton","1012","929","83","18672","9","6","3","4372","80664","18626","1218","17384","24"
"2022-06-20T00:00:00.000","67","Hebron","1554","1363","191","16351","15","11","4","7521","79135","30170","1863","28281","26"
"2022-06-20T00:00:00.000","68","Kent","554","503","51","19950","2","2","0","3878","139647","23963","668","23293","2"
"2022-06-20T00:00:00.000","69","Killingly","4540","4308","232","26188","80","57","23","15337","88469","67983","5500","62425","58"
"2022-06-20T00:00:00.000","70","Killingworth","1078","983","95","16939","11","6","5","5387","84648","23665","1262","22374","29"
"2022-06-20T00:00:00.000","71","Lebanon","1416","1300","116","19821","7","6","1","6021","84281","26146","1719","24410","17"
"2022-06-20T00:00:00.000","72","Ledyard","3334","3033","301","22803","14","13","1","13686","93605","57367","3937","53367","63"
"2022-06-20T00:00:00.000","73","Lisbon","899","820","79","21303","13","13","0","3137","74336","14281","1098","13158","25"
"2022-06-20T00:00:00.000","74","Litchfield","1290","1166","124","15938","13","11","2","6893","85162","29951","1520","28399","32"
"2022-06-20T00:00:00.000","75","Lyme","327","302","25","14119","1","0","1","1959","84585","7758","386","7368","4"
"2022-06-20T00:00:00.000","76","Madison","3387","3127","260","18785","46","36","10","17582","97515","83394","4034","79283","77"
"2022-06-20T00:00:00.000","77","Manchester","11788","10302","1486","20471","192","139","53","48764","84683","221767","14456","207044","267"
"2022-06-20T00:00:00.000","78","Mansfield","2962","2681","281","11622","32","27","5","17343","68046","97809","3402","94302","105"
"2022-06-20T00:00:00.000","79","Marlborough","1144","984","160","18058","31","22","9","5293","83552","26056","1414","24616","26"
"2022-06-20T00:00:00.000","80","Meriden","17313","15732","1581","29149","220","195","25","56091","94437","315817","21726","293654","437"
"2022-06-20T00:00:00.000","81","Middlebury","1626","1354","272","20852","23","18","5","7221","92601","35544","2033","33441","70"
"2022-06-20T00:00:00.000","82","Middlefield","712","638","74","16278","5","3","2","3665","83791","17048","919","16115","14"
"2022-06-20T00:00:00.000","83","Middletown","10971","10007","964","23717","183","136","47","43765","94611","463724","13781","449445","498"
"2022-06-20T00:00:00.000","84","Milford","12217","11045","1172","22315","183","159","24","46574","85071","220922","15082","205627","213"
"2022-06-20T00:00:00.000","85","Monroe","4149","3507","642","21349","25","17","8","17301","89024","70876","5009","65802","65"
"2022-06-20T00:00:00.000","86","Montville","4569","4207","362","24687","49","44","5","16962","91647","99448","5471","93866","111"
"2022-06-20T00:00:00.000","87","Morris","335","308","27","14862","3","3","0","1821","80790","7412","389","7017","6"
"2022-06-20T00:00:00.000","88","Naugatuck","8285","6893","1392","26633","139","121","18","27451","88244","151234","10578","140350","306"
"2022-06-20T00:00:00.000","89","New Britain","20400","18779","1621","28140","273","225","48","64230","88599","315579","25402","289688","489"
"2022-06-20T00:00:00.000","90","New Canaan","3628","3219","409","17931","44","38","6","21694","107221","86422","4318","82039","65"
"2022-06-20T00:00:00.000","91","New Fairfield","2583","2156","427","18612","9","6","3","11729","84515","41842","3037","38761","44"
"2022-06-20T00:00:00.000","92","New Hartford","1113","1037","76","16722","6","5","1","5245","78801","20671","1338","19314","19"
"2022-06-20T00:00:00.000","93","New Haven","35759","33128","2631","27454","289","256","33","128409","98587","926160","44513","880357","1290"
"2022-06-20T00:00:00.000","94","Newington","6733","6220","513","22433","138","117","21","26432","88066","129037","8355","120515","167"
"2022-06-20T00:00:00.000","95","New London","7980","7454","526","29712","50","44","6","30807","114703","337776","9779","327698","299"
"2022-06-20T00:00:00.000","96","New Milford","5273","3575","1698","19672","63","45","18","24030","89647","104515","6223","98149","143"
"2022-06-20T00:00:00.000","97","Newtown","5131","4245","886","18397","80","68","12","24635","88326","116383","6150","110141","92"
"2022-06-20T00:00:00.000","98","Norfolk","141","132","9","8650","1","1","0","793","48650","3469","164","3302","3"
"2022-06-20T00:00:00.000","99","North Branford","3196","2754","442","22593","29","15","14","11758","83119","56733","3843","52833","57"
"2022-06-20T00:00:00.000","100","North Canaan","549","530","19","16887","19","18","1","3093","95140","18049","626","17405","18"
"2022-06-20T00:00:00.000","101","North Haven","6017","4919","1098","25406","65","61","4","22261","93996","112557","7328","105129","100"
"2022-06-20T00:00:00.000","102","North Stonington","1010","925","85","19438","9","7","2","4006","77098","15580","1187","14382","11"
"2022-06-20T00:00:00.000","103","Norwalk","23348","21202","2146","26288","271","236","35","89593","100875","380866","29902","350546","418"
"2022-06-20T00:00:00.000","104","Norwich","10630","9501","1129","27420","101","86","15","36663","94570","167215","13218","153848","149"
"2022-06-20T00:00:00.000","105","Old Lyme","1325","1251","74","18136","4","3","1","7197","98508","28268","1609","26635","24"
"2022-06-20T00:00:00.000","106","Old Saybrook","2164","2016","148","21509","66","53","13","10180","101183","47475","2647","44786","42"
"2022-06-20T00:00:00.000","107","Orange","3012","2711","301","21629","24","21","3","12864","92374","55263","3582","51631","50"
"2022-06-20T00:00:00.000","108","Oxford","2526","2240","286","19057","33","32","1","10778","81313","45041","3087","41904","50"
"2022-06-20T00:00:00.000","109","Plainfield","3883","3596","287","25673","55","47","8","12670","83769","56364","4712","51624","28"
"2022-06-20T00:00:00.000","110","Plainville","3938","3365","573","22459","60","57","3","14547","82965","73253","4899","68261","93"
"2022-06-20T00:00:00.000","111","Plymouth","2403","2049","354","20719","19","16","3","9454","81514","45003","2957","41990","56"
"2022-06-20T00:00:00.000","112","Pomfret","819","727","92","19486","7","6","1","4438","105591","21880","989","20881","10"
"2022-06-20T00:00:00.000","113","Portland","1659","1509","150","17902","30","22","8","8046","86824","39905","2022","37847","36"
"2022-06-20T00:00:00.000","114","Preston","1094","991","103","23654","9","9","0","4111","88886","18417","1281","17109","27"
"2022-06-20T00:00:00.000","115","Prospect","2101","1808","293","21655","10","10","0","7901","81437","36757","2607","34099","51"
"2022-06-20T00:00:00.000","116","Putnam","2228","2127","101","23730","36","33","3","8157","86878","32093","2691","29375","27"
"2022-06-20T00:00:00.000","117","Redding","1413","1251","162","15500","22","18","4","8004","87802","32451","1749","30668","34"
"2022-06-20T00:00:00.000","118","Ridgefield","4380","3930","450","17549","69","52","17","23896","95741","99415","5353","93967","95"
"2022-06-20T00:00:00.000","119","Rocky Hill","4311","3835","476","21432","150","126","24","17258","85797","89609","5507","83974","128"
"2022-06-20T00:00:00.000","120","Roxbury","318","226","92","14777","2","0","2","1950","90613","6855","367","6485","3"
"2022-06-20T00:00:00.000","121","Salem","827","775","52","20255","5","5","0","3545","86823","14884","1022","13846","16"
"2022-06-20T00:00:00.000","122","Salisbury","548","488","60","15222","2","1","1","5147","142972","22827","650","22164","13"
"2022-06-20T00:00:00.000","123","Scotland","122","118","4","7297","2","2","0","484","28947","2030","149","1881","0"
"2022-06-20T00:00:00.000","124","Seymour","3999","3535","464","24329","83","68","15","14242","86646","69992","4859","64995","138"
"2022-06-20T00:00:00.000","125","Sharon","294","284","10","10933","4","3","1","2242","83377","9495","361","9131","3"
"2022-06-20T00:00:00.000","126","Shelton","9865","8597","1268","23986","212","169","43","37196","90437","173567","12129","161168","270"
"2022-06-20T00:00:00.000","127","Sherman","520","358","162","14325","3","0","3","3119","85923","10516","581","9916","19"
"2022-06-20T00:00:00.000","128","Simsbury","3663","3335","328","14424","34","29","5","21995","86612","93940","4292","89561","87"
"2022-06-20T00:00:00.000","129","Somers","2106","1941","165","19529","23","20","3","8338","77318","60043","2458","57507","78"
"2022-06-20T00:00:00.000","130","Southbury","3584","2905","679","18313","85","72","13","17153","87645","88084","4521","83467","96"
"2022-06-20T00:00:00.000","131","Southington","9242","7903","1339","21084","135","115","20","36398","83036","182369","11391","170764","214"
"2022-06-20T00:00:00.000","132","South Windsor","4619","4168","451","17655","67","44","23","21389","81756","80798","5424","75261","113"
"2022-06-20T00:00:00.000","133","Sprague","765","696","69","26758","6","5","1","2699","94404","13746","922","12813","11"
"2022-06-20T00:00:00.000","134","Stafford","1708","1549","159","14361","34","26","8","7465","62768","33741","2084","31623","34"
"2022-06-20T00:00:00.000","135","Stamford","31105","28707","2398","23994","384","336","48","130819","100911","493937","39770","453669","498"
"2022-06-20T00:00:00.000","136","Sterling","767","710","57","20280","3","3","0","2755","72845","10484","910","9563","11"
"2022-06-20T00:00:00.000","137","Stonington","3540","3200","340","19074","60","40","20","16599","89439","74660","4360","70239","61"
"2022-06-20T00:00:00.000","138","Stratford","13927","11921","2006","26861","201","166","35","48489","93520","227305","17376","209634","295"
"2022-06-20T00:00:00.000","139","Suffield","3648","3126","522","23068","51","39","12","14571","92140","117376","4474","112822","80"
"2022-06-20T00:00:00.000","140","Thomaston","1869","1575","294","24804","18","18","0","6344","84194","31235","2341","28866","28"
"2022-06-20T00:00:00.000","141","Thompson","1822","1718","104","19426","13","8","5","6594","70306","26467","2171","24254","42"
"2022-06-20T00:00:00.000","142","Tolland","2303","2067","236","15755","25","12","13","11644","79655","45762","2702","43012","48"
"2022-06-20T00:00:00.000","143","Torrington","7947","7537","410","23343","182","162","20","29437","86468","155581","9794","145528","259"
"2022-06-20T00:00:00.000","144","Trumbull","8880","7771","1109","24893","176","122","54","35576","99728","166259","11001","155034","224"
"2022-06-20T00:00:00.000","145","Union","217","200","17","25864","2","2","0","1084","129201","4346","252","4090","4"
"2022-06-20T00:00:00.000","146","Vernon","5041","4527","514","17170","78","52","26","22332","76065","91665","5883","85652","130"
"2022-06-20T00:00:00.000","147","Voluntown","527","492","35","20996","6","6","0","2121","84502","8401","624","7770","7"
"2022-06-20T00:00:00.000","148","Wallingford","10705","9551","1154","24151","217","187","30","40241","90784","233679","13186","220221","272"
"2022-06-20T00:00:00.000","149","Warren","157","115","42","11254","0","0","0","1026","73548","3830","179","3646","5"
"2022-06-20T00:00:00.000","150","Washington","538","444","94","15694","2","2","0","3996","116569","17883","614","17253","16"
"2022-06-20T00:00:00.000","151","Waterbury","33729","29485","4244","31356","503","442","61","106699","99192","544695","43490","500294","911"
"2022-06-20T00:00:00.000","152","Waterford","4461","4167","294","23797","76","57","19","18118","96650","87113","5374","81649","90"
"2022-06-20T00:00:00.000","153","Watertown","5213","4446","767","24159","77","70","7","19416","89981","95460","6645","88664","151"
"2022-06-20T00:00:00.000","154","Westbrook","1313","1231","82","19115","10","6","4","6193","90159","24140","1617","22495","28"
"2022-06-20T00:00:00.000","155","West Hartford","11721","10380","1341","18615","273","206","67","58825","93425","293351","14326","278728","297"
"2022-06-20T00:00:00.000","156","West Haven","13660","11923","1737","25009","164","149","15","49475","90580","242434","17034","225125","275"
"2022-06-20T00:00:00.000","157","Weston","1685","1530","155","16436","5","3","2","10332","100780","41005","2046","38926","33"
"2022-06-20T00:00:00.000","158","Westport","5201","4752","449","18255","37","27","10","30526","107143","144292","6340","137844","108"
"2022-06-20T00:00:00.000","159","Wethersfield","5939","5495","444","22835","55","46","9","22913","88100","107804","7319","100365","120"
"2022-06-20T00:00:00.000","160","Willington","809","727","82","13796","4","4","0","4117","70208","16381","928","15439","14"
"2022-06-20T00:00:00.000","161","Wilton","3233","2969","264","17625","55","29","26","18806","102524","72446","3874","68543","29"
"2022-06-20T00:00:00.000","162","Winchester","1836","1762","74","17314","16","16","0","8292","78197","33920","2164","31731","25"
"2022-06-20T00:00:00.000","163","Windham","6975","6551","424","28399","71","48","23","22367","91067","117280","8983","108151","146"
"2022-06-20T00:00:00.000","164","Windsor","7026","6434","592","24453","164","126","38","27181","94599","152443","8879","143401","163"
"2022-06-20T00:00:00.000","165","Windsor Locks","2691","2499","192","20935","44","40","4","10489","81601","44624","3335","41234","55"
"2022-06-20T00:00:00.000","166","Wolcott","4077","3550","527","24579","64","54","10","14314","86296","71275","5149","66021","105"
"2022-06-20T00:00:00.000","167","Woodbridge","1691","1512","179","19326","48","42","6","8657","98937","50354","2107","48176","71"
"2022-06-20T00:00:00.000","168","Woodbury","1640","1361","279","17260","12","10","2","7910","83246","34168","2014","32126","28"
"2022-06-20T00:00:00.000","169","Woodstock","1440","1391","49","18325","7","7","0","6736","85722","23628","1680","21919","29"
"2022-06-17T00:00:00.000","1","Andover","506","432","74","15637","6","4","2","2433","75185","9337","582","8747","8"
"2022-06-17T00:00:00.000","2","Ansonia","4887","4200","687","26198","49","39","10","16280","87274","76716","6018","70541","157"
"2022-06-17T00:00:00.000","3","Ashford","738","665","73","17344","5","4","1","3393","79741","13093","888","12192","13"
"2022-06-17T00:00:00.000","4","Avon","2999","2752","247","16409","81","65","16","17061","93352","74546","3522","70943","81"
"2022-06-17T00:00:00.000","5","Barkhamsted","524","489","35","14531","8","7","1","2692","74653","10965","616","10335","14"
"2022-06-17T00:00:00.000","6","Beacon Falls","1299","1155","144","20878","11","11","0","4896","78689","23136","1576","21516","44"
"2022-06-17T00:00:00.000","7","Berlin","4079","3736","343","19960","52","45","7","16503","80755","75037","4938","70016","83"
"2022-06-17T00:00:00.000","8","Bethany","988","898","90","17808","4","3","1","4650","83814","23280","1207","22042","31"
"2022-06-17T00:00:00.000","9","Bethel","4077","3335","742","20591","71","56","15","18081","91318","74286","4913","69290","83"
"2022-06-17T00:00:00.000","10","Bethlehem","615","525","90","18078","3","2","1","2785","81864","11808","744","11042","22"
"2022-06-17T00:00:00.000","11","Bloomfield","4927","4504","423","23229","136","116","20","20183","95153","133349","6173","126977","199"
"2022-06-17T00:00:00.000","12","Bolton","751","653","98","15377","5","4","1","3954","80958","14975","889","14075","11"
"2022-06-17T00:00:00.000","13","Bozrah","609","560","49","22340","7","7","0","2223","81548","10000","733","9258","9"
"2022-06-17T00:00:00.000","14","Branford","5907","5315","592","21172","82","73","9","25472","91297","124090","7100","116850","140"
"2022-06-17T00:00:00.000","15","Bridgeport","42594","38395","4199","29497","450","370","80","139911","96892","684448","54824","628549","1075"
"2022-06-17T00:00:00.000","16","Bridgewater","201","134","67","12294","0","0","0","1426","87217","5269","241","5022","6"
"2022-06-17T00:00:00.000","17","Bristol","14403","12386","2017","24026","210","171","39","52389","87392","272268","17832","254086","350"
"2022-06-17T00:00:00.000","18","Brookfield","3709","2970","739","21852","27","20","7","15809","93142","62548","4427","58061","60"
"2022-06-17T00:00:00.000","19","Brooklyn","2116","2006","110","25580","18","18","0","7563","91429","45637","2578","43031","28"
"2022-06-17T00:00:00.000","20","Burlington","1745","1494","251","17982","8","6","2","7894","81348","33498","2095","31365","38"
"2022-06-17T00:00:00.000","21","Canaan","28","27","1","2659","0","0","0","356","33808","1280","35","1245","0"
"2022-06-17T00:00:00.000","22","Canterbury","1129","1047","82","22229","4","4","0","4077","80272","16961","1343","15602","16"
"2022-06-17T00:00:00.000","23","Canton","1451","1310","141","14151","39","32","7","8252","80476","34978","1677","33275","26"
"2022-06-17T00:00:00.000","24","Chaplin","444","414","30","19830","3","3","0","1790","79946","7492","525","6965","2"
"2022-06-17T00:00:00.000","25","Cheshire","6325","5609","716","21858","80","66","14","26328","90984","165976","7588","158242","146"
"2022-06-17T00:00:00.000","26","Chester","613","559","54","14550","19","16","3","3509","83290","17205","765","16415","25"
"2022-06-17T00:00:00.000","27","Clinton","2634","2457","177","20379","14","9","5","11812","91389","48947","3189","45701","57"
"2022-06-17T00:00:00.000","28","Colchester","3130","2807","323","19799","42","29","13","13865","87703","63081","3788","59221","72"
"2022-06-17T00:00:00.000","29","Colebrook","145","136","9","10357","1","1","0","856","61143","3657","166","3487","4"
"2022-06-17T00:00:00.000","30","Columbia","971","859","112","18052","12","9","3","4472","83138","17934","1151","16768","15"
"2022-06-17T00:00:00.000","31","Cornwall","189","180","9","13877","2","0","2","1404","103084","5030","217","4810","3"
"2022-06-17T00:00:00.000","32","Coventry","2106","1822","284","16974","11","10","1","9927","80011","38376","2472","35863","41"
"2022-06-17T00:00:00.000","33","Cromwell","2958","2644","314","21374","66","42","24","12595","91011","66382","3628","62665","89"
"2022-06-17T00:00:00.000","34","Danbury","20955","18783","2172","24742","218","181","37","80751","95344","321952","25725","295734","493"
"2022-06-17T00:00:00.000","35","Darien","3862","3404","458","17774","13","12","1","22608","104050","91673","4688","86906","79"
"2022-06-17T00:00:00.000","36","Deep River","754","707","47","16971","1","1","0","3834","86293","15609","914","14675","20"
"2022-06-17T00:00:00.000","37","Derby","3113","2646","467","25229","30","24","6","10956","88792","49903","3807","46003","93"
"2022-06-17T00:00:00.000","38","Durham","1460","1323","137","20377","9","8","1","6177","86211","29731","1767","27936","28"
"2022-06-17T00:00:00.000","39","Eastford","278","265","13","15531","4","3","1","1218","68045","4427","331","4095","1"
"2022-06-17T00:00:00.000","40","East Granby","873","772","101","16984","4","2","2","4360","84825","18021","1071","16940","10"
"2022-06-17T00:00:00.000","41","East Haddam","1332","1155","177","14805","23","10","13","6785","75414","30413","1564","28822","27"
"2022-06-17T00:00:00.000","42","East Hampton","2337","2016","321","18258","25","18","7","10592","82750","45405","2802","42554","49"
"2022-06-17T00:00:00.000","43","East Hartford","13715","12463","1252","27500","198","155","43","44883","89996","227006","17325","209345","336"
"2022-06-17T00:00:00.000","44","East Haven","7607","6618","989","26627","107","87","20","25846","90469","126306","9352","116830","124"
"2022-06-17T00:00:00.000","45","East Lyme","3705","3424","281","20068","61","48","13","17997","97481","93635","4429","89150","56"
"2022-06-17T00:00:00.000","46","Easton","1401","1224","177","18628","5","4","1","7088","94243","26511","1708","24774","29"
"2022-06-17T00:00:00.000","47","East Windsor","2209","1993","216","18932","61","46","15","9252","79294","46689","2719","43906","64"
"2022-06-17T00:00:00.000","48","Ellington","2370","2152","218","14392","33","21","12","12191","74033","42536","2758","39729","49"
"2022-06-17T00:00:00.000","49","Enfield","9114","8247","867","20875","89","79","10","34764","79626","185901","11145","174478","278"
"2022-06-17T00:00:00.000","50","Essex","1058","974","84","15867","13","12","1","5871","88047","26790","1311","25455","24"
"2022-06-17T00:00:00.000","51","Fairfield","15061","13534","1527","24274","244","185","59","65588","105710","373330","18030","354900","400"
"2022-06-17T00:00:00.000","52","Farmington","4569","4032","537","17920","67","54","13","23434","91909","113822","5424","108252","146"
"2022-06-17T00:00:00.000","53","Franklin","432","407","25","22500","2","2","0","1489","77552","6855","526","6320","9"
"2022-06-17T00:00:00.000","54","Glastonbury","6107","5426","681","17711","118","97","21","30166","87483","126444","7447","118859","138"
"2022-06-17T00:00:00.000","55","Goshen","446","413","33","15578","2","2","0","2475","86448","9636","542","9085","9"
"2022-06-17T00:00:00.000","56","Granby","1540","1339","201","13383","33","28","5","8944","77727","35821","1828","33951","42"
"2022-06-17T00:00:00.000","57","Greenwich","14300","13306","994","22756","124","100","24","66308","105519","299758","17436","282097","225"
"2022-06-17T00:00:00.000","58","Griswold","2916","2659","257","25282","32","23","9","10215","88564","44936","3527","41375","34"
"2022-06-17T00:00:00.000","59","Groton","7890","7056","834","20528","122","78","44","33324","86700","148411","9509","138756","146"
"2022-06-17T00:00:00.000","60","Guilford","4320","3938","382","19518","44","35","9","20507","92654","100071","5115","94864","92"
"2022-06-17T00:00:00.000","61","Haddam","1419","1324","95","17320","11","6","5","6857","83693","29871","1715","28135","21"
"2022-06-17T00:00:00.000","62","Hamden","14089","12235","1854","23266","234","199","35","58680","96902","410569","17321","392831","417"
"2022-06-17T00:00:00.000","63","Hampton","465","440","25","25244","1","1","0","1886","102389","7816","551","7262","3"
"2022-06-17T00:00:00.000","64","Hartford","33742","31462","2280","27634","417","368","49","114748","93975","675716","42383","632398","935"
"2022-06-17T00:00:00.000","65","Hartland","245","222","23","11557","5","4","1","1328","62642","4974","296","4672","6"
"2022-06-17T00:00:00.000","66","Harwinton","1010","927","83","18635","9","6","3","4372","80664","18645","1215","17406","24"
"2022-06-17T00:00:00.000","67","Hebron","1550","1359","191","16309","15","11","4","7519","79114","30133","1859","28248","26"
"2022-06-17T00:00:00.000","68","Kent","554","503","51","19950","2","2","0","3874","139503","23966","668","23296","2"
"2022-06-17T00:00:00.000","69","Killingly","4535","4303","232","26159","80","57","23","15329","88423","67901","5494","62349","58"
"2022-06-17T00:00:00.000","70","Killingworth","1074","980","94","16876","11","6","5","5385","84617","23634","1258","22348","28"
"2022-06-17T00:00:00.000","71","Lebanon","1416","1300","116","19821","7","6","1","6019","84253","26105","1719","24369","17"
"2022-06-17T00:00:00.000","72","Ledyard","3330","3029","301","22775","14","13","1","13677","93544","57261","3932","53266","63"
"2022-06-17T00:00:00.000","73","Lisbon","896","817","79","21232","13","13","0","3130","74171","14242","1093","13124","25"
"2022-06-17T00:00:00.000","74","Litchfield","1286","1164","122","15888","13","11","2","6890","85125","29912","1516","28364","32"
"2022-06-17T00:00:00.000","75","Lyme","326","301","25","14076","1","0","1","1957","84499","7744","385","7355","4"
"2022-06-17T00:00:00.000","76","Madison","3371","3113","258","18697","46","36","10","17571","97454","83209","4018","79115","76"
"2022-06-17T00:00:00.000","77","Manchester","11767","10284","1483","20434","192","139","53","48724","84614","221502","14429","206806","267"
"2022-06-17T00:00:00.000","78","Mansfield","2957","2676","281","11602","32","27","5","17336","68019","97761","3396","94260","105"
"2022-06-17T00:00:00.000","79","Marlborough","1142","982","160","18027","31","22","9","5292","83536","26025","1412","24587","26"
"2022-06-17T00:00:00.000","80","Meriden","17289","15707","1582","29109","220","195","25","56061","94387","315344","21695","293212","437"
"2022-06-17T00:00:00.000","81","Middlebury","1624","1353","271","20826","23","18","5","7210","92460","35483","2032","33381","70"
"2022-06-17T00:00:00.000","82","Middlefield","709","635","74","16209","5","3","2","3664","83768","17025","915","16096","14"
"2022-06-17T00:00:00.000","83","Middletown","10965","10001","964","23704","183","136","47","43759","94598","463390","13767","449125","498"
"2022-06-17T00:00:00.000","84","Milford","12196","11021","1175","22277","183","159","24","46545","85018","220623","15050","205360","213"
"2022-06-17T00:00:00.000","85","Monroe","4140","3498","642","21303","25","17","8","17286","88947","70774","4998","65711","65"
"2022-06-17T00:00:00.000","86","Montville","4564","4200","364","24660","49","44","5","16949","91577","99258","5464","93684","110"
"2022-06-17T00:00:00.000","87","Morris","334","307","27","14818","3","3","0","1818","80657","7403","388","7009","6"
"2022-06-17T00:00:00.000","88","Naugatuck","8277","6884","1393","26607","139","121","18","27425","88161","151118","10567","140245","306"
"2022-06-17T00:00:00.000","89","New Britain","20377","18757","1620","28108","273","225","48","64193","88548","315143","25373","289281","489"
"2022-06-17T00:00:00.000","90","New Canaan","3616","3207","409","17872","44","38","6","21675","107127","86310","4307","81938","65"
"2022-06-17T00:00:00.000","91","New Fairfield","2581","2154","427","18598","9","6","3","11723","84472","41782","3034","38704","44"
"2022-06-17T00:00:00.000","92","New Hartford","1111","1035","76","16692","6","5","1","5246","78816","20665","1336","19311","18"
"2022-06-17T00:00:00.000","93","New Haven","35698","33071","2627","27407","289","256","33","128333","98528","925073","44444","879346","1283"
"2022-06-17T00:00:00.000","94","Newington","6721","6212","509","22393","138","117","21","26419","88022","128894","8337","120390","167"
"2022-06-17T00:00:00.000","95","New London","7973","7448","525","29686","50","44","6","30776","114588","337730","9767","327664","299"
"2022-06-17T00:00:00.000","96","New Milford","5263","3566","1697","19634","63","45","18","24014","89588","104352","6214","97996","142"
"2022-06-17T00:00:00.000","97","Newtown","5124","4238","886","18372","80","68","12","24616","88258","116232","6143","109997","92"
"2022-06-17T00:00:00.000","98","Norfolk","140","132","8","8589","1","1","0","795","48773","3470","163","3304","3"
"2022-06-17T00:00:00.000","99","North Branford","3185","2743","442","22515","29","15","14","11742","83006","56601","3831","52713","57"
"2022-06-17T00:00:00.000","100","North Canaan","549","530","19","16887","19","18","1","3092","95109","18039","626","17395","18"
"2022-06-17T00:00:00.000","101","North Haven","6007","4908","1099","25364","65","61","4","22260","93991","112422","7316","105006","100"
"2022-06-17T00:00:00.000","102","North Stonington","1007","922","85","19380","9","7","2","3998","76944","15550","1183","14356","11"
"2022-06-17T00:00:00.000","103","Norwalk","23317","21171","2146","26253","271","236","35","89540","100815","380229","29861","349950","418"
"2022-06-17T00:00:00.000","104","Norwich","10610","9483","1127","27368","101","86","15","36625","94472","166855","13194","153512","149"
"2022-06-17T00:00:00.000","105","Old Lyme","1320","1247","73","18067","4","3","1","7191","98426","28199","1603","26572","24"
"2022-06-17T00:00:00.000","106","Old Saybrook","2153","2006","147","21399","66","53","13","10167","101054","47399","2636","44721","42"
"2022-06-17T00:00:00.000","107","Orange","2999","2698","301","21535","24","21","3","12845","92238","55172","3570","51552","50"
"2022-06-17T00:00:00.000","108","Oxford","2524","2238","286","19042","33","32","1","10771","81260","44962","3081","41831","50"
"2022-06-17T00:00:00.000","109","Plainfield","3879","3592","287","25646","55","47","8","12671","83775","56306","4707","51571","28"
"2022-06-17T00:00:00.000","110","Plainville","3933","3360","573","22431","60","57","3","14534","82890","73194","4890","68211","93"
"2022-06-17T00:00:00.000","111","Plymouth","2400","2046","354","20693","19","16","3","9455","81523","44962","2954","41952","56"
"2022-06-17T00:00:00.000","112","Pomfret","816","724","92","19415","7","6","1","4435","105520","21865","985","20870","10"
"2022-06-17T00:00:00.000","113","Portland","1655","1505","150","17859","30","22","8","8037","86727","39893","2017","37840","36"
"2022-06-17T00:00:00.000","114","Preston","1093","990","103","23632","9","9","0","4108","88822","18395","1280","17088","27"
"2022-06-17T00:00:00.000","115","Prospect","2101","1808","293","21655","10","10","0","7902","81447","36725","2605","34069","51"
"2022-06-17T00:00:00.000","116","Putnam","2228","2127","101","23730","36","33","3","8149","86793","32048","2689","29332","27"
"2022-06-17T00:00:00.000","117","Redding","1410","1249","161","15467","22","18","4","7996","87714","32407","1746","30627","34"
"2022-06-17T00:00:00.000","118","Ridgefield","4367","3917","450","17497","69","52","17","23875","95657","99333","5338","93900","95"
"2022-06-17T00:00:00.000","119","Rocky Hill","4303","3828","475","21392","150","126","24","17239","85702","89518","5498","83892","128"
"2022-06-17T00:00:00.000","120","Roxbury","318","226","92","14777","2","0","2","1948","90520","6850","367","6480","3"
"2022-06-17T00:00:00.000","121","Salem","826","774","52","20230","5","5","0","3540","86701","14858","1020","13822","16"
"2022-06-17T00:00:00.000","122","Salisbury","547","487","60","15194","2","1","1","5150","143056","22825","649","22163","13"
"2022-06-17T00:00:00.000","123","Scotland","122","118","4","7297","2","2","0","483","28888","2027","149","1878","0"
"2022-06-17T00:00:00.000","124","Seymour","3991","3526","465","24281","83","68","15","14226","86549","69913","4849","64926","138"
"2022-06-17T00:00:00.000","125","Sharon","293","283","10","10896","4","3","1","2244","83451","9491","360","9128","3"
"2022-06-17T00:00:00.000","126","Shelton","9842","8574","1268","23930","212","169","43","37158","90345","173345","12103","160972","270"
"2022-06-17T00:00:00.000","127","Sherman","520","358","162","14325","3","0","3","3111","85702","10501","581","9901","19"
"2022-06-17T00:00:00.000","128","Simsbury","3656","3330","326","14397","34","29","5","21973","86525","93813","4283","89443","87"
"2022-06-17T00:00:00.000","129","Somers","2101","1937","164","19483","23","20","3","8329","77235","59996","2451","57468","77"
"2022-06-17T00:00:00.000","130","Southbury","3578","2901","677","18282","85","72","13","17140","87579","87989","4514","83379","96"
"2022-06-17T00:00:00.000","131","Southington","9224","7892","1332","21043","135","115","20","36382","82999","182185","11367","170604","214"
"2022-06-17T00:00:00.000","132","South Windsor","4603","4151","452","17594","67","44","23","21378","81714","80713","5402","75200","111"
"2022-06-17T00:00:00.000","133","Sprague","764","696","68","26723","6","5","1","2699","94404","13727","921","12795","11"
"2022-06-17T00:00:00.000","134","Stafford","1706","1547","159","14345","34","26","8","7456","62692","33695","2082","31579","34"
"2022-06-17T00:00:00.000","135","Stamford","31052","28658","2394","23953","384","336","48","130741","100851","493298","39703","453097","498"
"2022-06-17T00:00:00.000","136","Sterling","767","710","57","20280","3","3","0","2754","72819","10476","910","9555","11"
"2022-06-17T00:00:00.000","137","Stonington","3526","3187","339","18999","60","40","20","16594","89412","74534","4344","70129","61"
"2022-06-17T00:00:00.000","138","Stratford","13906","11900","2006","26820","201","166","35","48476","93495","226968","17347","209326","295"
"2022-06-17T00:00:00.000","139","Suffield","3618","3094","524","22878","51","39","12","14553","92026","116211","4430","111702","79"
"2022-06-17T00:00:00.000","140","Thomaston","1864","1570","294","24738","18","18","0","6342","84167","31205","2337","28840","28"
"2022-06-17T00:00:00.000","141","Thompson","1819","1715","104","19394","13","8","5","6591","70274","26421","2168","24211","42"
"2022-06-17T00:00:00.000","142","Tolland","2298","2063","235","15720","25","12","13","11639","79621","45715","2696","42971","48"
"2022-06-17T00:00:00.000","143","Torrington","7933","7524","409","23302","182","162","20","29418","86412","155336","9778","145299","259"
"2022-06-17T00:00:00.000","144","Trumbull","8868","7758","1110","24859","176","122","54","35555","99669","165965","10983","154758","224"
"2022-06-17T00:00:00.000","145","Union","217","200","17","25864","2","2","0","1082","128963","4342","252","4086","4"
"2022-06-17T00:00:00.000","146","Vernon","5031","4520","511","17136","78","52","26","22313","76001","91538","5871","85537","130"
"2022-06-17T00:00:00.000","147","Voluntown","527","492","35","20996","6","6","0","2120","84462","8391","624","7760","7"
"2022-06-17T00:00:00.000","148","Wallingford","10667","9516","1151","24065","217","187","30","40209","90712","233364","13145","219947","272"
"2022-06-17T00:00:00.000","149","Warren","157","115","42","11254","0","0","0","1025","73477","3826","179","3642","5"
"2022-06-17T00:00:00.000","150","Washington","538","444","94","15694","2","2","0","3993","116482","17856","614","17226","16"
"2022-06-17T00:00:00.000","151","Waterbury","33687","29447","4240","31317","503","442","61","106650","99147","544095","43430","499754","911"
"2022-06-17T00:00:00.000","152","Waterford","4452","4161","291","23749","76","57","19","18114","96629","86988","5361","81537","90"
"2022-06-17T00:00:00.000","153","Watertown","5208","4441","767","24136","77","70","7","19407","89939","95381","6636","88594","151"
"2022-06-17T00:00:00.000","154","Westbrook","1311","1229","82","19086","10","6","4","6186","90057","24123","1614","22481","28"
"2022-06-17T00:00:00.000","155","West Hartford","11676","10339","1337","18544","273","206","67","58771","93339","292920","14276","278347","297"
