"day","borough","swimming_pool","program_type","male_registration","female_registration","total_registration","male_attendance","female_attendance","total_attendance"
"2019-08-30T00:00:00.000","Staten Island","Lyons","Night Owl","0","0","0","3","14","17"
"2019-08-30T00:00:00.000","Queens","Astoria","Night Owl","0","0","0","10","19","29"
"2019-08-30T00:00:00.000","Bronx","Crotona","Night Owl","0","0","0","1","1","2"
"2019-08-30T00:00:00.000","Bronx","Van Cortlandt","Night Owl","0","0","0","7","17","24"
"2019-08-30T00:00:00.000","Brooklyn","Sunset","Night Owl","0","0","0","18","9","27"
"2019-08-30T00:00:00.000","Brooklyn","Red Hook","Night Owl","0","0","0","13","12","25"
"2019-08-30T00:00:00.000","Brooklyn","McCarren","Night Owl","0","0","0","42","38","80"
"2019-08-30T00:00:00.000","Manhattan","Tony Dapolito","Night Owl","0","0","0","1","2","3"
"2019-08-30T00:00:00.000","Manhattan","Marcus Garvey","Night Owl","0","1","1","5","17","22"
"2019-08-30T00:00:00.000","Manhattan","Asser Levy","Night Owl","0","0","0","9","4","13"
"2019-08-30T00:00:00.000","Manhattan","Lasker","Night Owl","0","0","0","10","15","25"
"2019-08-30T00:00:00.000","Manhattan","John Jay","Night Owl","0","0","0","30","26","56"
"2019-08-30T00:00:00.000","Manhattan","Hamilton Fish","Night Owl","0","0","0","14","12","26"
"2019-08-29T00:00:00.000","Staten Island","Lyons","Night Owl","0","0","0","5","4","9"
"2019-08-29T00:00:00.000","Queens","Astoria","Night Owl","1","0","1","12","16","28"
"2019-08-29T00:00:00.000","Bronx","Crotona","Night Owl","0","0","0","1","0","1"
"2019-08-29T00:00:00.000","Bronx","Van Cortlandt","Night Owl","0","0","0","6","16","22"
"2019-08-29T00:00:00.000","Brooklyn","Sunset","Night Owl","0","2","2","13","15","28"
"2019-08-29T00:00:00.000","Brooklyn","Red Hook","Night Owl","1","3","4","12","12","24"
"2019-08-29T00:00:00.000","Brooklyn","McCarren","Night Owl","0","2","2","45","46","91"
"2019-08-29T00:00:00.000","Manhattan","Tony Dapolito","Night Owl","0","1","1","3","7","10"
"2019-08-29T00:00:00.000","Manhattan","Marcus Garvey","Night Owl","0","2","2","7","11","18"
"2019-08-29T00:00:00.000","Manhattan","Asser Levy","Night Owl","0","1","1","19","14","33"
"2019-08-29T00:00:00.000","Manhattan","Lasker","Night Owl","0","2","2","17","21","38"
"2019-08-29T00:00:00.000","Manhattan","John Jay","Night Owl","3","2","5","22","26","48"
"2019-08-29T00:00:00.000","Manhattan","Hamilton Fish","Night Owl","0","0","0","10","12","22"
"2019-08-28T00:00:00.000","Staten Island","Lyons","Night Owl","0","0","0","2","0","2"
"2019-08-28T00:00:00.000","Queens","Astoria","Night Owl","0","1","1","3","7","10"
"2019-08-28T00:00:00.000","Bronx","Crotona","Night Owl","0","0","0","0","1","1"
"2019-08-28T00:00:00.000","Bronx","Van Cortlandt","Night Owl","0","0","0","3","5","8"
"2019-08-28T00:00:00.000","Brooklyn","Sunset","Night Owl","0","0","0","10","3","13"
"2019-08-28T00:00:00.000","Brooklyn","Red Hook","Night Owl","0","1","1","2","4","6"
"2019-08-28T00:00:00.000","Brooklyn","McCarren","Night Owl","1","1","2","19","12","31"
"2019-08-28T00:00:00.000","Manhattan","Tony Dapolito","Night Owl","0","0","0","4","2","6"
"2019-08-28T00:00:00.000","Manhattan","Marcus Garvey","Night Owl","0","0","0","3","1","4"
"2019-08-28T00:00:00.000","Manhattan","Asser Levy","Night Owl","0","0","0","6","6","12"
"2019-08-28T00:00:00.000","Manhattan","Lasker","Night Owl","0","0","0","9","7","16"
"2019-08-28T00:00:00.000","Manhattan","John Jay","Night Owl","3","2","5","12","6","18"
"2019-08-28T00:00:00.000","Manhattan","Hamilton Fish","Night Owl","0","0","0","3","4","7"
"2019-08-27T00:00:00.000","Staten Island","Lyons","Night Owl","0","0","0","3","4","7"
"2019-08-27T00:00:00.000","Queens","Astoria","Night Owl","1","2","3","20","16","36"
"2019-08-27T00:00:00.000","Bronx","Crotona","Night Owl","0","0","0","0","1","1"
"2019-08-27T00:00:00.000","Bronx","Van Cortlandt","Night Owl","0","0","0","4","3","7"
"2019-08-27T00:00:00.000","Brooklyn","Red Hook","Night Owl","0","2","2","7","9","16"
"2019-08-27T00:00:00.000","Brooklyn","Red Hook","Night Owl","0","4","4","8","9","17"
"2019-08-27T00:00:00.000","Brooklyn","McCarren","Night Owl","0","0","0","19","30","49"
"2019-08-27T00:00:00.000","Manhattan","Tony Dapolito","Night Owl","0","1","1","4","5","9"
"2019-08-27T00:00:00.000","Manhattan","Marcus Garvey","Night Owl","0","1","1","4","5","9"
"2019-08-27T00:00:00.000","Manhattan","Asser Levy","Night Owl","3","0","3","9","6","15"
"2019-08-27T00:00:00.000","Manhattan","Lasker","Night Owl","0","2","2","9","13","22"
"2019-08-27T00:00:00.000","Manhattan","John Jay","Night Owl","1","0","1","21","13","34"
"2019-08-27T00:00:00.000","Manhattan","Hamilton Fish","Night Owl","0","0","0","17","5","22"
"2019-08-26T00:00:00.000","Staten Island","Lyons","Night Owl","0","0","0","3","6","9"
"2019-08-26T00:00:00.000","Queens","Astoria","Night Owl","4","0","4","31","18","49"
"2019-08-26T00:00:00.000","Bronx","Crotona","Night Owl","0","1","1","0","1","1"
"2019-08-26T00:00:00.000","Bronx","Van Cortlandt","Night Owl","0","0","0","6","8","14"
"2019-08-26T00:00:00.000","Brooklyn","Sunset","Night Owl","2","3","5","20","16","36"
"2019-08-26T00:00:00.000","Brooklyn","Red Hook","Night Owl","0","1","1","13","11","24"
"2019-08-23T00:00:00.000","Brooklyn","McCarren","Night Owl","2","1","3","34","28","62"
"2019-08-26T00:00:00.000","Manhattan","Tony Dapolito","Night Owl","1","0","1","4","4","8"
"2019-08-26T00:00:00.000","Manhattan","Marcus Garvey","Night Owl","0","0","0","5","7","12"
"2019-08-26T00:00:00.000","Manhattan","Asser Levy","Night Owl","0","0","0","11","9","20"
"2019-08-26T00:00:00.000","Manhattan","Lasker","Night Owl","0","0","0","12","9","21"
"2019-08-26T00:00:00.000","Manhattan","John Jay","Night Owl","3","0","3","17","17","34"
"2019-08-26T00:00:00.000","Manhattan","Hamilton Fish","Night Owl","0","0","0","30","15","45"
"2019-08-23T00:00:00.000","Staten Island","Lyons","Night Owl","0","1","1","2","8","10"
"2019-08-23T00:00:00.000","Queens","Astoria","Night Owl","0","2","2","22","15","37"
"2019-08-23T00:00:00.000","Bronx","Crotona","Night Owl","0","0","0","2","1","3"
"2019-08-23T00:00:00.000","Bronx","Van Cortlandt","Night Owl","0","0","0","9","9","18"
"2019-08-23T00:00:00.000","Brooklyn","Sunset","Night Owl","0","0","0","19","7","26"
"2019-08-23T00:00:00.000","Brooklyn","Red Hook","Night Owl","0","1","1","10","4","14"
"2019-08-23T00:00:00.000","Brooklyn","McCarren","Night Owl","1","2","3","31","19","50"
"2019-08-23T00:00:00.000","Manhattan","Tony Dapolito","Night Owl","0","0","0","3","3","6"
"2019-08-23T00:00:00.000","Manhattan","Marcus Garvey","Night Owl","0","0","0","4","4","8"
"2019-08-23T00:00:00.000","Manhattan","Asser Levy","Night Owl","2","0","2","10","9","19"
"2019-08-23T00:00:00.000","Manhattan","Lasker","Night Owl","2","5","7","16","14","30"
"2019-08-23T00:00:00.000","Manhattan","John Jay","Night Owl","2","3","5","20","18","38"
"2019-08-23T00:00:00.000","Manhattan","Hamilton Fish","Night Owl","1","1","2","14","15","29"
"2019-08-22T00:00:00.000","Staten Island","Lyons","Night Owl","2","3","5","6","12","18"
"2019-08-22T00:00:00.000","Queens","Astoria","Night Owl","1","1","2","28","33","61"
"2019-08-22T00:00:00.000","Bronx","Crotona","Night Owl","0","0","0","2","2","4"
"2019-08-22T00:00:00.000","Bronx","Van Cortlandt","Night Owl","1","1","2","9","15","24"
"2019-08-22T00:00:00.000","Brooklyn","Sunset","Night Owl","0","0","0","0","0","0"
"2019-08-22T00:00:00.000","Brooklyn","Red Hook","Night Owl","1","3","4","12","16","28"
"2019-08-22T00:00:00.000","Brooklyn","McCarren","Night Owl","7","8","15","57","60","117"
"2019-08-22T00:00:00.000","Manhattan","Tony Dapolito","Night Owl","0","2","2","4","7","11"
"2019-08-22T00:00:00.000","Manhattan","Marcus Garvey","Night Owl","0","0","0","0","0","0"
"2019-08-22T00:00:00.000","Manhattan","Asser Levy","Night Owl","0","1","1","12","18","30"
"2019-08-22T00:00:00.000","Manhattan","Lasker","Night Owl","4","7","11","22","31","53"
"2019-08-22T00:00:00.000","Manhattan","John Jay","Night Owl","4","8","12","36","40","76"
"2019-08-22T00:00:00.000","Manhattan","Hamilton Fish","Night Owl","8","7","15","30","34","64"
"2019-08-21T00:00:00.000","Staten Island","Lyons","Night Owl","0","1","1","1","12","13"
"2019-08-21T00:00:00.000","Queens","Astoria","Night Owl","3","1","4","20","23","43"
"2019-08-21T00:00:00.000","Bronx","Crotona","Night Owl","0","0","0","1","0","1"
"2019-08-21T00:00:00.000","Bronx","Van Cortlandt","Night Owl","1","1","2","9","12","21"
"2019-08-21T00:00:00.000","Brooklyn","Sunset","Night Owl","0","0","0","18","1","19"
"2019-08-21T00:00:00.000","Brooklyn","Red Hook","Night Owl","2","0","2","12","10","22"
"2019-08-21T00:00:00.000","Brooklyn","McCarren","Night Owl","0","3","3","32","28","60"
"2019-08-21T00:00:00.000","Manhattan","Tony Dapolito","Night Owl","0","0","0","3","9","12"
"2019-08-21T00:00:00.000","Manhattan","Marcus Garvey","Night Owl","0","0","0","4","7","11"
"2019-08-21T00:00:00.000","Manhattan","Asser Levy","Night Owl","0","0","0","14","9","23"
"2019-08-21T00:00:00.000","Manhattan","Lasker","Night Owl","3","6","9","18","24","42"
"2019-08-21T00:00:00.000","Manhattan","John Jay","Night Owl","4","4","8","24","26","50"
"2019-08-21T00:00:00.000","Manhattan","Hamilton Fish","Night Owl","0","2","2","17","18","35"
"2019-08-20T00:00:00.000","Staten Island","Lyons","Night Owl","0","5","5","2","18","20"
"2019-08-20T00:00:00.000","Queens","Astoria","Night Owl","8","9","17","54","40","94"
"2019-08-20T00:00:00.000","Bronx","Crotona","Night Owl","0","0","0","3","2","5"
"2019-08-20T00:00:00.000","Bronx","Van Cortlandt","Night Owl","0","1","1","11","11","22"
"2019-08-20T00:00:00.000","Brooklyn","Sunset","Night Owl","2","5","7","19","16","35"
"2019-08-20T00:00:00.000","Brooklyn","Red Hook","Night Owl","2","5","7","19","16","35"
"2019-08-20T00:00:00.000","Brooklyn","McCarren","Night Owl","5","7","12","60","51","111"
"2019-08-20T00:00:00.000","Manhattan","Tony Dapolito","Night Owl","1","2","3","10","12","22"
"2019-08-20T00:00:00.000","Manhattan","Marcus Garvey","Night Owl","1","0","1","9","11","20"
"2010-08-20T00:00:00.000","Manhattan","Marcus Garvey","Night Owl","1","0","1","9","11","20"
"2019-08-20T00:00:00.000","Manhattan","Asser Levy","Night Owl","3","6","9","16","21","37"
"2019-08-20T00:00:00.000","Manhattan","Lasker","Night Owl","0","7","7","22","35","57"
"2019-08-20T00:00:00.000","Manhattan","John Jay","Night Owl","4","7","11","30","37","67"
"2019-08-20T00:00:00.000","Manhattan","Hamilton Fish","Night Owl","6","4","10","43","30","73"
"2019-08-19T00:00:00.000","Staten Island","Crotona","Night Owl","0","0","0","7","12","19"
"2019-08-19T00:00:00.000","Queens","Astoria","Night Owl","4","8","12","43","37","80"
"2019-08-19T00:00:00.000","Bronx","Crotona","Night Owl","0","1","1","2","2","4"
"2019-08-19T00:00:00.000","Bronx","Van Cortlandt","Night Owl","1","1","2","8","16","24"
"2019-08-19T00:00:00.000","Brooklyn","Sunset","Night Owl","4","1","5","30","17","47"
"2019-08-19T00:00:00.000","Brooklyn","Red Hook","Night Owl","1","8","9","14","20","34"
"2019-08-19T00:00:00.000","Brooklyn","McCarren","Night Owl","11","11","22","68","72","140"
"2019-08-19T00:00:00.000","Manhattan","Tony Dapolito","Night Owl","1","1","2","7","14","21"
"2019-08-19T00:00:00.000","Manhattan","Marcus Garvey","Night Owl","0","2","2","7","11","18"
"2019-08-19T00:00:00.000","Manhattan","Asser Levy","Night Owl","2","4","6","17","20","37"
"2019-08-19T00:00:00.000","Manhattan","Lasker","Night Owl","2","3","5","29","25","54"
"2019-08-19T00:00:00.000","Manhattan","John Jay","Night Owl","5","8","13","35","33","68"
"2019-08-19T00:00:00.000","Manhattan","Hamilton Fish","Night Owl","7","4","11","34","40","74"
"2019-08-16T00:00:00.000","Staten Island","Lyons","Night Owl","0","0","0","4","12","16"
"2019-08-16T00:00:00.000","Queens","Astoria","Night Owl","6","32","38","30",,"30"
"2019-08-16T00:00:00.000","Bronx","Crotona","Night Owl","0","0","0","1","1","2"
"2019-08-16T00:00:00.000","Bronx","Van Cortlandt","Night Owl","2","1","3","12","13","25"
"2019-08-16T00:00:00.000","Brooklyn","Sunset","Night Owl","0","0","0","14","10","24"
"2019-08-16T00:00:00.000","Brooklyn","Red Hook","Night Owl","1","0","1","19","13","32"
"2019-08-16T00:00:00.000","Brooklyn","McCarren","Night Owl","1","4","5","46","36","82"
"2019-08-16T00:00:00.000","Manhattan","Tony Dapolito","Night Owl","1","0","1","9","6","15"
"2019-08-16T00:00:00.000","Manhattan","Marcus Garvey","Night Owl","1","4","5","6","12","18"
"2019-08-16T00:00:00.000","Manhattan","Asser Levy","Night Owl","2","0","2","16","10","26"
"2019-08-16T00:00:00.000","Manhattan","Lasker","Night Owl","5","2","7","13","19","32"
"2019-08-16T00:00:00.000","Manhattan","John Jay","Night Owl","2","0","2","32","30","62"
"2019-08-16T00:00:00.000","Manhattan","Hamilton Fish","Night Owl","3","0","3","30","21","51"
"2019-08-15T00:00:00.000","Staten Island","Lyons","Night Owl","0","0","0","3","7","10"
"2019-08-15T00:00:00.000","Queens","Astoria","Night Owl","7","8","15","35","36","71"
"2019-08-15T00:00:00.000","Bronx","Crotona","Night Owl","0","0","0","4","2","6"
"2019-08-15T00:00:00.000","Bronx","Van Cortlandt","Night Owl","0","1","1","10","36","46"
"2019-08-15T00:00:00.000","Brooklyn","Sunset","Night Owl","4","0","4","18","27","45"
"2019-08-15T00:00:00.000","Brooklyn","Red Hook","Night Owl","0","0","0","12","0","12"
"2019-08-15T00:00:00.000","Brooklyn","McCarren","Night Owl","9","10","19","35","50","85"
"2019-08-15T00:00:00.000","Manhattan","Tony Dapolito","Night Owl","0","1","1","5","7","12"
"2019-08-15T00:00:00.000","Manhattan","Marcus Garvey","Night Owl","2","2","4","11","12","23"
"2019-08-15T00:00:00.000","Manhattan","Lasker","Night Owl","0","4","4","15","28","43"
"2019-08-15T00:00:00.000","Manhattan","John Jay","Night Owl","6","8","14","25","23","48"
"2019-08-15T00:00:00.000","Manhattan","Hamilton Fish","Night Owl","7","3","10","22","39","61"
"2019-08-14T00:00:00.000","Staten Island","Lyons","Night Owl","0","0","0","3","3","6"
"2019-08-14T00:00:00.000","Queens","Astoria","Night Owl","2","2","4","35","28","63"
"2019-08-14T00:00:00.000","Bronx","Crotona","Night Owl","0","0","0","4","0","4"
"2019-08-14T00:00:00.000","Bronx","Van Cortlandt","Night Owl","2","0","2","10","4","14"
"2019-08-14T00:00:00.000","Brooklyn","Sunset","Night Owl","0","1","1","18","5","23"
"2019-08-14T00:00:00.000","Brooklyn","Red Hook","Night Owl","0","12","12","8",,"8"
"2019-08-14T00:00:00.000","Brooklyn","McCarren","Night Owl","3","8","11","35","40","75"
"2019-08-14T00:00:00.000","Manhattan","Tony Dapolito","Night Owl","0","1","1","5","5","10"
"2019-08-14T00:00:00.000","Manhattan","Marcus Garvey","Night Owl","1","2","3","8","12","20"
"2019-08-14T00:00:00.000","Manhattan","Asser Levy","Night Owl","2","0","2","11","11","22"
"2019-08-14T00:00:00.000","Manhattan","Lasker","Night Owl","3","2","5","15","17","32"
"2019-08-14T00:00:00.000","Manhattan","John Jay","Night Owl","5","1","6","25","19","44"
"2019-08-14T00:00:00.000","Manhattan","Hamilton Fish","Night Owl","2","4","6","22","14","36"
"2019-08-13T00:00:00.000","Staten Island","Lyons","Early Bird","0","0","0","4","3","7"
"2019-08-13T00:00:00.000","Queens","Astoria","Night Owl","4","1","5","24","12","36"
"2019-08-13T00:00:00.000","Bronx","Crotona","Night Owl","0","0","0","4","1","5"
"2019-08-13T00:00:00.000","Bronx","Van Cortlandt","Night Owl","0","0","0","6","7","13"
"2019-08-13T00:00:00.000","Brooklyn","Sunset","Night Owl","0","0","0","16","12","28"
"2019-08-13T00:00:00.000","Brooklyn","Red Hook","Night Owl","1","1","2","10","8","18"
"2019-08-13T00:00:00.000","Brooklyn","McCarren","Night Owl","5","4","9","44","26","70"
"2019-08-13T00:00:00.000","Manhattan","Tony Dapolito","Night Owl","2","0","2","13","5","18"
"2019-08-13T00:00:00.000","Manhattan","Marcus Garvey","Night Owl","0","0","0","1","5","6"
"2019-08-13T00:00:00.000","Manhattan","Asser Levy","Night Owl","1","2","3","7","11","18"
"2019-08-13T00:00:00.000","Manhattan","Lasker","Night Owl","3","5","8","16","18","34"
"2019-08-13T00:00:00.000","Manhattan","John Jay","Night Owl","2","3","5","22","17","39"
"2019-08-13T00:00:00.000","Manhattan","Hamilton Fish","Night Owl","5","0","5","22","17","39"
"2019-08-12T00:00:00.000","Staten Island","Lyons","Night Owl","0","1","1","12","15","27"
"2019-08-12T00:00:00.000","Queens","Astoria","Night Owl","10","10","20","43","37","80"
"2019-08-12T00:00:00.000","Bronx","Crotona","Night Owl","0","0","0","2","2","4"
"2019-08-12T00:00:00.000","Bronx","Van Cortlandt","Night Owl","1","2","3","9","20","29"
"2019-08-12T00:00:00.000","Brooklyn","Sunset","Night Owl","1","4","5","24","27","51"
"2019-08-12T00:00:00.000","Brooklyn","Red Hook","Night Owl","4","3","7","22","15","37"
"2019-08-12T00:00:00.000","Brooklyn","McCarren","Night Owl","9","11","20","75","85","160"
"2019-08-12T00:00:00.000","Manhattan","Tony Dapolito","Night Owl","2","1","3","9","12","21"
"2019-08-12T00:00:00.000","Manhattan","Marcus Garvey","Night Owl","3","2","5","8","12","20"
"2019-08-12T00:00:00.000","Manhattan","Asser Levy","Night Owl","2","1","3","18","14","32"
"2019-08-12T00:00:00.000","Manhattan","Lasker","Night Owl","9","9","18","35","41","76"
"2019-08-12T00:00:00.000","Manhattan","John Jay","Night Owl","3","4","7","41","40","81"
"2019-08-12T00:00:00.000","Manhattan","Hamilton Fish","Night Owl","1","9","10","39","31","70"
"2019-08-09T00:00:00.000","Staten Island","Lyons","Night Owl","0","0","0","6","5","11"
"2019-08-09T00:00:00.000","Queens","Astoria","Night Owl","5","4","9","35","35","70"
"2019-08-09T00:00:00.000","Bronx","Crotona","Night Owl","0","0","0","2","1","3"
"2019-08-09T00:00:00.000","Bronx","Van Cortlandt","Night Owl","1","1","2","19","14","33"
"2019-08-09T00:00:00.000","Brooklyn","Sunset","Night Owl","7","5","12","28","19","47"
"2019-08-09T00:00:00.000","Brooklyn","Red Hook","Night Owl","0","0","0","0","0","0"
"2019-08-09T00:00:00.000","Brooklyn","McCarren","Night Owl","4","10","14","35","37","72"
"2019-08-09T00:00:00.000","Manhattan","Tony Dapolito","Night Owl","0","1","1","8","7","15"
"2019-08-09T00:00:00.000","Manhattan","Marcus Garvey","Night Owl","1","0","1","9","9","18"
"2019-08-09T00:00:00.000","Manhattan","Asser Levy","Night Owl","1","1","2","6","9","15"
"2019-08-09T00:00:00.000","Manhattan","Lasker","Night Owl","0","2","2","23","27","50"
"2019-08-09T00:00:00.000","Manhattan","John Jay","Night Owl","4","5","9","30","31","61"
"2019-08-09T00:00:00.000","Manhattan","Hamilton Fish","Night Owl","2","3","5","21","20","41"
"2019-08-08T00:00:00.000","Staten Island","Lyons","Night Owl","0","0","0","7","16","23"
"2019-08-08T00:00:00.000","Queens","Astoria","Night Owl","6","5","11","37","37","74"
"2019-08-08T00:00:00.000","Bronx","Crotona","Night Owl","0","0","0","3","1","4"
"2019-08-08T00:00:00.000","Bronx","Van Cortlandt","Night Owl","5","3","8","10","23","33"
"2019-08-08T00:00:00.000","Brooklyn","Sunset","Night Owl","1","1","2","22","21","43"
"2019-08-08T00:00:00.000","Brooklyn","Red Hook","Night Owl","2","2","4","18","17","35"
"2019-08-08T00:00:00.000","Brooklyn","McCarren","Night Owl","4","9","13","49","51","100"
"2019-08-08T00:00:00.000","Manhattan","Tony Dapolito","Night Owl","0","1","1","12","8","20"
"2019-08-08T00:00:00.000","Manhattan","Marcus Garvey","Night Owl","0","0","0","9","14","23"
"2019-08-08T00:00:00.000","Manhattan","Marcus Garvey","Night Owl","0","0","0","9","14","23"
"2019-08-08T00:00:00.000","Manhattan","Asser Levy","Night Owl","2","1","3","15","13","28"
"2019-08-08T00:00:00.000","Manhattan","Lasker","Night Owl","3","1","4","26","27","53"
"2019-08-08T00:00:00.000","Manhattan","John Jay","Night Owl","3","6","9","27","38","65"
"2019-08-08T00:00:00.000","Manhattan","Hamilton Fish","Night Owl","9","5","14","42","22","64"
"2019-08-07T00:00:00.000","Staten Island","Lyons","Night Owl","0","0","0","0","0","0"
"2019-08-07T00:00:00.000","Queens","Astoria","Night Owl","0","0","0","0","0","0"
"2019-08-07T00:00:00.000","Bronx","Crotona","Night Owl","0","0","0","0","0","0"
"2019-08-07T00:00:00.000","Bronx","Van Cortlandt","Night Owl","0","0","0","0","0","0"
"2019-08-07T00:00:00.000","Brooklyn","Sunset","Night Owl","0","0","0","0","0","0"
"2019-08-07T00:00:00.000","Brooklyn","Red Hook","Night Owl","0","0","0","0","0","0"
"2019-08-07T00:00:00.000","Brooklyn","McCarren","Night Owl","0","0","0","0","0","0"
"2019-08-07T00:00:00.000","Manhattan","Tony Dapolito","Night Owl","1","0","1","1","0","1"
"2019-08-07T00:00:00.000","Manhattan","Marcus Garvey","Night Owl","0","0","0","0","0","0"
"2019-08-07T00:00:00.000","Manhattan","Asser Levy","Night Owl","0","0","0","1","1","2"
"2019-08-07T00:00:00.000","Manhattan","Lasker","Night Owl","0","0","0","0","0","0"
"2019-08-07T00:00:00.000","Manhattan","John Jay","Night Owl","0","0","0","0","0","0"
"2019-08-07T00:00:00.000","Manhattan","Hamilton Fish","Night Owl","0","0","0","0","0","0"
"2019-08-06T00:00:00.000","Staten Island","Crotona","Night Owl","0","2","2","6","17","23"
"2019-08-06T00:00:00.000","Queens","Astoria","Night Owl","10","4","14","45","34","79"
"2019-08-06T00:00:00.000","Bronx","Crotona","Night Owl","1","2","3","5","4","9"
"2019-08-06T00:00:00.000","Bronx","Van Cortlandt","Night Owl","1","2","3","10","16","26"
"2019-08-06T00:00:00.000","Brooklyn","Sunset","Night Owl","3","4","7","33","21","54"
"2019-08-06T00:00:00.000","Brooklyn","Red Hook","Night Owl","0","0","0","0","0","0"
"2019-08-06T00:00:00.000","Brooklyn","McCarren","Night Owl","11","6","17","66","46","112"
"2019-08-06T00:00:00.000","Manhattan","Tony Dapolito","Night Owl","4","1","5","10","14","24"
"2019-08-06T00:00:00.000","Manhattan","Marcus Garvey","Night Owl","2","3","5","9","15","24"
"2019-08-06T00:00:00.000","Manhattan","Asser Levy","Night Owl","2","2","4","16","19","35"
"2019-08-06T00:00:00.000","Manhattan","Lasker","Night Owl","5","8","13","26","29","55"
"2019-08-06T00:00:00.000","Manhattan","John Jay","Night Owl","2","6","8","26","29","55"
"2019-08-06T00:00:00.000","Manhattan","Hamilton Fish","Night Owl","10","4","14","27","41","68"
"2019-08-05T00:00:00.000","Staten Island","Lyons","Night Owl","0","3","3","10","16","26"
"2019-08-05T00:00:00.000","Queens","Astoria","Night Owl","5","9","14","38","46","84"
"2019-08-05T00:00:00.000","Bronx","Crotona","Night Owl","2","0","2","7","2","9"
"2019-08-05T00:00:00.000","Bronx","Van Cortlandt","Night Owl","1","0","1","8","13","21"
"2019-08-05T00:00:00.000","Brooklyn","Sunset","Night Owl","0","0","0","0","0","0"
"2019-08-05T00:00:00.000","Brooklyn","Red Hook","Night Owl","0","0","0","0","0","0"
"2019-08-05T00:00:00.000","Brooklyn","McCarren","Night Owl","9","12","21","48","38","86"
"2019-08-05T00:00:00.000","Manhattan","Tony Dapolito","Night Owl","0","3","3","6","10","16"
"2019-08-05T00:00:00.000","Manhattan","Marcus Garvey","Night Owl","2","2","4","6","14","20"
"2019-08-05T00:00:00.000","Manhattan","Asser Levy","Night Owl","0","3","3","14","14","28"
"2019-08-05T00:00:00.000","Manhattan","Lasker","Night Owl","8","8","16","44","41","85"
"2019-08-05T00:00:00.000","Manhattan","John Jay","Night Owl","6","10","16","39","46","85"
"2019-08-05T00:00:00.000","Manhattan","Hamilton Fish","Night Owl","5","3","8","51","26","77"
"2019-08-02T00:00:00.000","Staten Island","Lyons","Night Owl","1","0","1","9","14","23"
"2019-08-02T00:00:00.000","Queens","Astoria","Night Owl","5","6","11","30","35","65"
"2019-08-02T00:00:00.000","Bronx","Crotona","Night Owl","0","1","1","2","1","3"
"2019-08-02T00:00:00.000","Bronx","Van Cortlandt","Night Owl","2","0","2","13","13","26"
"2019-08-02T00:00:00.000","Brooklyn","Sunset","Night Owl","5","5","10","26","25","51"
"2019-08-02T00:00:00.000","Brooklyn","Red Hook","Night Owl","1","5","6","16","16","32"
"2019-08-02T00:00:00.000","Brooklyn","McCarren","Night Owl","5","17","22","32","61","93"
"2019-08-02T00:00:00.000","Manhattan","Tony Dapolito","Night Owl","1","0","1","10","7","17"
"2019-08-02T00:00:00.000","Manhattan","Marcus Garvey","Night Owl","0","0","0","6","7","13"
"2019-08-02T00:00:00.000","Manhattan","Asser Levy","Night Owl","0","3","3","14","14","28"
"2019-08-02T00:00:00.000","Manhattan","Lasker","Night Owl","7","8","15","41","38","79"
"2019-08-02T00:00:00.000","Manhattan","John Jay","Night Owl","7","6","13","26","35","61"
"2019-08-02T00:00:00.000","Manhattan","Hamilton Fish","Night Owl","9","7","16","43","32","75"
"2019-08-01T00:00:00.000","Staten Island","Lyons","Night Owl","0","2","2","8","10","18"
"2019-08-01T00:00:00.000","Queens","Astoria","Night Owl","6","13","19","37","59","96"
"2019-08-01T00:00:00.000","Bronx","Crotona","Night Owl","1","1","2","9","3","12"
"2019-08-01T00:00:00.000","Bronx","Van Cortlandt","Night Owl","7","1","8","17","22","39"
"2019-08-01T00:00:00.000","Brooklyn","Sunset","Night Owl","5","4","9","31","29","60"
"2019-08-01T00:00:00.000","Brooklyn","Red Hook","Night Owl","4","5","9","23","33","56"
"2019-08-01T00:00:00.000","Brooklyn","McCarren","Night Owl","8","11","19","63","59","122"
"2019-08-01T00:00:00.000","Manhattan","Tony Dapolito","Night Owl","3","4","7","14","12","26"
"2019-08-01T00:00:00.000","Manhattan","Marcus Garvey","Night Owl","1","0","1","8","13","21"
"2019-08-01T00:00:00.000","Manhattan","Asser Levy","Night Owl","2","4","6","17","20","37"
"2019-08-01T00:00:00.000","Manhattan","Lasker","Night Owl","3","6","9","33","37","70"
"2019-08-01T00:00:00.000","Manhattan","John Jay","Night Owl","3","8","11","37","45","82"
"2019-08-01T00:00:00.000","Manhattan","Hamilton Fish","Night Owl","10","5","15","42","35","77"
"2019-07-31T00:00:00.000","Staten Island","Lyons","Night Owl","0","0","0","7","2","9"
"2019-07-31T00:00:00.000","Queens","Astoria","Night Owl","1","5","6","17","16","33"
"2019-07-31T00:00:00.000","Bronx","Crotona","Night Owl","0","0","0","2","0","2"
"2019-07-31T00:00:00.000","Bronx","Van Cortlandt","Night Owl","0","1","1","3","5","8"
"2019-07-31T00:00:00.000","Brooklyn","Sunset","Night Owl","0","0","0","12","4","16"
"2019-07-31T00:00:00.000","Brooklyn","Red Hook","Night Owl","2","0","2","15","9","24"
"2019-07-31T00:00:00.000","Brooklyn","McCarren","Night Owl","5","3","8","22","18","40"
"2019-07-31T00:00:00.000","Manhattan","Tony Dapolito","Night Owl","0","1","1","4","3","7"
"2019-07-31T00:00:00.000","Manhattan","Marcus Garvey","Night Owl","1","0","1","3","2","5"
"2019-07-31T00:00:00.000","Manhattan","Asser Levy","Night Owl","1","0","1","13","19","32"
"2019-07-31T00:00:00.000","Manhattan","Lasker","Night Owl","3","2","5","13","11","24"
"2019-07-31T00:00:00.000","Manhattan","John Jay","Night Owl","7","3","10","15","12","27"
"2019-07-31T00:00:00.000","Manhattan","Hamilton Fish","Night Owl","2","0","2","24","13","37"
"2019-07-30T00:00:00.000","Staten Island","Lyons","Night Owl","0","2","2","10","19","29"
"2019-07-30T00:00:00.000","Queens","Astoria","Night Owl","7","21","28","46","59","105"
"2019-07-30T00:00:00.000","Bronx","Crotona","Night Owl","1","0","1","1","1","2"
"2019-07-30T00:00:00.000","Bronx","Van Cortlandt","Night Owl","2","3","5","15","21","36"
"2019-07-30T00:00:00.000","Brooklyn","Sunset","Night Owl","4","6","10","29","41","70"
"2019-07-30T00:00:00.000","Brooklyn","Red Hook","Night Owl","7","13","20","38","49","87"
"2019-07-30T00:00:00.000","Brooklyn","McCarren","Night Owl","11","26","37","66","86","152"
"2019-07-30T00:00:00.000","Manhattan","Tony Dapolito","Night Owl","1","3","4","11","16","27"
"2019-07-30T00:00:00.000","Manhattan","Marcus Garvey","Night Owl","3","9","12","7","25","32"
"2019-07-30T00:00:00.000","Manhattan","Asser Levy","Night Owl","2","3","5","20","22","42"
"2019-07-30T00:00:00.000","Manhattan","Lasker","Night Owl","18","25","43","47","71","118"
"2019-07-30T00:00:00.000","Manhattan","John Jay","Night Owl","9","12","21","48","48","96"
"2019-07-30T00:00:00.000","Manhattan","Hamilton Fish","Night Owl","6","5","11","46","29","75"
"2019-07-29T00:00:00.000","Staten Island","Lyons","Night Owl","3","1","4","13","15","28"
"2029-07-29T00:00:00.000","Queens","Astoria","Night Owl","8","24","32","48","70","118"
"2019-07-29T00:00:00.000","Bronx","Crotona","Night Owl","0","0","0","3","1","4"
"2019-07-29T00:00:00.000","Bronx","Van Cortlandt","Night Owl","7","9","16","12","25","37"
"2019-07-29T00:00:00.000","Brooklyn","Sunset","Night Owl","13","10","23","40","41","81"
"2019-07-29T00:00:00.000","Brooklyn","Red Hook","Night Owl","7","8","15","27","28","55"
"2019-07-29T00:00:00.000","Brooklyn","McCarren","Night Owl","25","33","58","84","84","168"
"2019-07-29T00:00:00.000","Manhattan","Tony Dapolito","Night Owl","3","6","9","17","19","36"
"2019-07-29T00:00:00.000","Manhattan","Marcus Garvey","Night Owl","2","5","7","11","20","31"
"2019-07-29T00:00:00.000","Manhattan","Asser Levy","Night Owl","3","2","5","20","21","41"
"2019-07-29T00:00:00.000","Manhattan","Lasker","Night Owl","20","25","45","58","59","117"
"2019-07-29T00:00:00.000","Manhattan","John Jay","Night Owl","9","12","21","50","54","104"
"2019-07-29T00:00:00.000","Manhattan","Hamilton Fish","Night Owl","10","10","20","51","35","86"
"2019-07-26T00:00:00.000","Staten Island","Lyons","Night Owl","0","0","0","8","9","17"
"2019-07-26T00:00:00.000","Queens","Astoria","Night Owl","13","14","27","38","38","76"
"2019-07-26T00:00:00.000","Bronx","Crotona","Night Owl","2","0","2","4","1","5"
"2019-07-26T00:00:00.000","Bronx","Van Cortlandt","Night Owl","2","4","6","7","16","23"
"2019-07-26T00:00:00.000","Brooklyn","Sunset","Night Owl","2","8","10","25","26","51"
"2019-07-26T00:00:00.000","Brooklyn","Red Hook","Night Owl","5","8","13","23","23","46"
"2019-07-26T00:00:00.000","Brooklyn","McCarren","Night Owl","13","13","26","52","45","97"
"2019-07-26T00:00:00.000","Manhattan","Tony Dapolito","Night Owl","0","2","2","10","9","19"
"2019-07-26T00:00:00.000","Manhattan","Marcus Garvey","Night Owl","2","0","2","9","16","25"
"2019-07-26T00:00:00.000","Manhattan","Asser Levy","Night Owl","1","4","5","19","17","36"
"2019-07-26T00:00:00.000","Manhattan","Lasker","Night Owl","4","13","17","34","39","73"
"2019-07-26T00:00:00.000","Manhattan","John Jay","Night Owl","4","11","15","28","28","56"
"2019-07-26T00:00:00.000","Manhattan","Hamilton Fish","Night Owl","8","9","17","47","41","88"
"2019-07-25T00:00:00.000","Staten Island","Lyons","Night Owl","2","3","5","10","14","24"
"2019-07-25T00:00:00.000","Queens","Astoria","Night Owl","16","14","30","45","60","105"
"2019-07-25T00:00:00.000","Bronx","Crotona","Night Owl","2","4","6","4","5","9"
"2019-07-25T00:00:00.000","Bronx","Van Cortlandt","Night Owl","4","4","8","15","19","34"
"2019-07-25T00:00:00.000","Brooklyn","Sunset","Night Owl","0","0","0","0","0","0"
"2019-07-25T00:00:00.000","Brooklyn","Red Hook","Night Owl","6","7","13","22","18","40"
"2019-07-25T00:00:00.000","Brooklyn","McCarren","Night Owl","13","22","35","54","57","111"
"2019-07-25T00:00:00.000","Manhattan","Tony Dapolito","Night Owl","1","4","5","7","17","24"
"2019-07-25T00:00:00.000","Manhattan","Marcus Garvey","Night Owl","2","3","5","11","13","24"
"2019-07-25T00:00:00.000","Manhattan","Asser Levy","Night Owl","3","8","11","19","19","38"
"2019-07-25T00:00:00.000","Manhattan","Lasker","Night Owl","9","7","16","38","35","73"
"2019-07-25T00:00:00.000","Manhattan","John Jay","Night Owl","9","16","25","31","42","73"
"2019-07-25T00:00:00.000","Manhattan","Hamilton Fish","Night Owl","9","7","16","51","37","88"
"2019-07-24T00:00:00.000","Staten Island","Lyons","Night Owl","0","2","2","8","10","18"
"2019-07-24T00:00:00.000","Queens","Astoria","Night Owl","16","18","34","46","54","100"
"2019-07-24T00:00:00.000","Bronx","Crotona","Night Owl","0","0","0","2","0","2"
"2019-07-24T00:00:00.000","Bronx","Van Cortlandt","Night Owl","3","1","4","15","15","30"
"2019-07-24T00:00:00.000","Brooklyn","Sunset","Night Owl","5","6","11","28","34","62"
"2019-07-24T00:00:00.000","Brooklyn","Red Hook","Night Owl","6","10","16","21","27","48"
"2019-07-24T00:00:00.000","Brooklyn","McCarren","Night Owl","14","16","30","70","78","148"
"2019-07-24T00:00:00.000","Manhattan","Tony Dapolito","Night Owl","1","2","3","8","11","19"
"2019-07-24T00:00:00.000","Manhattan","Marcus Garvey","Night Owl","0","3","3","8","18","26"
"2019-07-24T00:00:00.000","Manhattan","Asser Levy","Night Owl","3","21","24","18","39","57"
"2019-07-24T00:00:00.000","Manhattan","Lasker","Night Owl","8","17","25","29","43","72"
"2019-07-24T00:00:00.000","Manhattan","John Jay","Night Owl","10","15","25","34","45","79"
"2019-07-24T00:00:00.000","Manhattan","Hamilton Fish","Night Owl","13","17","30","59","42","101"
"2019-07-23T00:00:00.000","Staten Island","Lyons","Night Owl","0","0","0","5","6","11"
"2019-07-23T00:00:00.000","Queens","Astoria","Night Owl","6","5","11","22","18","40"
"2019-07-23T00:00:00.000","Bronx","Crotona","Night Owl","0","0","0","4","1","5"
"2019-07-23T00:00:00.000","Bronx","Van Cortlandt","Night Owl","2","3","5","7","12","19"
"2019-07-23T00:00:00.000","Brooklyn","Red Hook","Night Owl","4","3","7","21","18","39"
"2019-07-23T00:00:00.000","Brooklyn","Red Hook","Night Owl","0","1","1","10","16","26"
"2019-07-23T00:00:00.000","Brooklyn","McCarren","Night Owl","8","5","13","36","20","56"
"2019-07-23T00:00:00.000","Manhattan","Tony Dapolito","Night Owl","2","0","2","9","8","17"
"2019-07-23T00:00:00.000","Manhattan","Marcus Garvey","Night Owl","1","2","3","8","4","12"
"2019-07-23T00:00:00.000","Manhattan","Asser Levy","Night Owl","1","1","2","8","4","12"
"2019-07-23T00:00:00.000","Manhattan","Lasker","Night Owl","2","2","4","18","15","33"
"2019-07-23T00:00:00.000","Manhattan","John Jay","Night Owl","12","14","26","28","17","45"
"2019-07-23T00:00:00.000","Manhattan","Hamilton Fish","Night Owl","6","3","9","38","17","55"
"2019-07-22T00:00:00.000","Staten Island","Lyons","Night Owl","0","0","0","0","0","0"
"2019-07-22T00:00:00.000","Queens","Astoria","Night Owl","0","1","1","0","0","0"
"2019-07-22T00:00:00.000","Bronx","Crotona","Night Owl","0","0","0","0","0","0"
"2019-07-22T00:00:00.000","Bronx","Van Cortlandt","Night Owl","0","0","0","0","0","0"
"2019-07-22T00:00:00.000","Brooklyn","Sunset","Night Owl","0","0","0","0","0","0"
"2019-07-22T00:00:00.000","Brooklyn","McCarren","Night Owl","0","0","0","0","0","0"
"2019-07-22T00:00:00.000","Brooklyn","McCarren","Night Owl","0","0","0","0","0","0"
"2019-07-22T00:00:00.000","Manhattan","Tony Dapolito","Night Owl","0","0","0","0","0","0"
"2019-07-22T00:00:00.000","Manhattan","Asser Levy","Night Owl","0","0","0","0","0","0"
"2019-07-22T00:00:00.000","Manhattan","Marcus Garvey","Night Owl","0","0","0","0","0","0"
"2019-07-22T00:00:00.000","Manhattan","Asser Levy","Night Owl","0","0","0","0","0","0"
"2019-07-22T00:00:00.000","Manhattan","Lasker","Night Owl","0","0","0","0","0","0"
"2019-07-22T00:00:00.000","Manhattan","Lasker","Night Owl","0","0","0","0","0","0"
"2019-07-22T00:00:00.000","Manhattan","John Jay","Night Owl","0","0","0","0","0","0"
"2019-07-22T00:00:00.000","Manhattan","Hamilton Fish","Night Owl","0","0","0","0","0","0"
"2019-07-19T00:00:00.000","Staten Island","Lyons","Night Owl","0","0","0","0","0","0"
"2019-07-19T00:00:00.000","Queens","Astoria","Night Owl","1","3","4","0","0","0"
"2019-07-19T00:00:00.000","Bronx","Crotona","Night Owl","0","1","1","0",,"0"
"2019-07-19T00:00:00.000","Bronx","Van Cortlandt","Night Owl","0","0","0","0","0","0"
"2019-07-19T00:00:00.000","Brooklyn","Sunset","Night Owl","0","0","0","0","0","0"
"2019-07-19T00:00:00.000","Brooklyn","Red Hook","Night Owl","0","0","0","0","0","0"
"2019-07-19T00:00:00.000","Brooklyn","McCarren","Night Owl","0","0","0","0","0","0"
"2019-07-19T00:00:00.000","Manhattan","Tony Dapolito","Night Owl","0","0","0","0","0","0"
"2019-07-19T00:00:00.000","Manhattan","Marcus Garvey","Night Owl","0","0","0","0","0","0"
"2019-07-19T00:00:00.000","Manhattan","Asser Levy","Night Owl","0","0","0","0","0","0"
"2019-07-19T00:00:00.000","Manhattan","Lasker","Night Owl","0","0","0","0","0","0"
"2019-07-19T00:00:00.000","Manhattan","John Jay","Night Owl","0","0","0","0","0","0"
"2019-07-19T00:00:00.000","Manhattan","Hamilton Fish","Night Owl","0","0","0","0","0","0"
"2019-07-18T00:00:00.000","Staten Island","Lyons","Night Owl","0","1","1","4","2","6"
"2819-07-18T00:00:00.000","Queens","Astoria","Night Owl","4","2","6","23","11","34"
"2019-07-18T00:00:00.000","Bronx","Crotona","Night Owl","0","0","0","2","0","2"
"2019-07-18T00:00:00.000","Bronx","Van Cortlandt","Night Owl","0","2","2","6","17","23"
"2019-07-18T00:00:00.000","Brooklyn","Sunset","Night Owl","3","3","6","13","25","38"
"2019-07-18T00:00:00.000","Brooklyn","Red Hook","Night Owl","0","1","1","5","6","11"
"2019-07-18T00:00:00.000","Brooklyn","McCarren","Night Owl","6","4","10","32","28","60"
"2019-07-18T00:00:00.000","Manhattan","Tony Dapolito","Night Owl","1","28","29","6",,"6"
"2019-07-18T00:00:00.000","Manhattan","Marcus Garvey","Night Owl","0","0","0","6","7","13"
"2019-07-18T00:00:00.000","Manhattan","Asser Levy","Night Owl","3","3","6","16","12","28"
"2019-07-18T00:00:00.000","Manhattan","Lasker","Night Owl","5","1","6","22","15","37"
"2019-07-18T00:00:00.000","Manhattan","John Jay","Night Owl","5","7","12","17","16","33"
"2019-07-18T00:00:00.000","Manhattan","Hamilton Fish","Night Owl","4","2","6","22","15","37"
"2019-07-17T00:00:00.000","Staten Island","Lyons","Night Owl","0","7","7","6","19","25"
"2019-07-17T00:00:00.000","Queens","Astoria","Night Owl","0","0","0","0","0","0"
"2019-07-17T00:00:00.000","Bronx","Crotona","Night Owl","0","7","7","5","18","23"
"2019-07-17T00:00:00.000","Bronx","Van Cortlandt","Night Owl","2","2","4","6","11","17"
"2019-07-17T00:00:00.000","Brooklyn","Sunset","Night Owl","2","11","13","23","24","47"
"2019-07-17T00:00:00.000","Brooklyn","Red Hook","Night Owl","3","4","7","16","16","32"
"2019-07-17T00:00:00.000","Brooklyn","McCarren","Night Owl","10","17","27","44","51","95"
"2019-07-17T00:00:00.000","Manhattan","Tony Dapolito","Night Owl","2","6","8","10","13","23"
"2019-07-17T00:00:00.000","Manhattan","Marcus Garvey","Night Owl","6","6","12","8","13","21"
"2019-07-17T00:00:00.000","Manhattan","Asser Levy","Night Owl","9","2","11","20","16","36"
"2019-07-17T00:00:00.000","Manhattan","Lasker","Night Owl","5","10","15","27","25","52"
"2019-07-17T00:00:00.000","Manhattan","John Jay","Early Bird","8","16","24","35","42","77"
"2019-07-17T00:00:00.000","Manhattan","Hamilton Fish","Night Owl","15","12","27","41","45","86"
"2019-07-16T00:00:00.000","Staten Island","Lyons","Night Owl","0","0","0","0","0","0"
"2019-07-16T00:00:00.000","Queens","Astoria","Night Owl","13","15","28","13","15","28"
"2019-07-16T00:00:00.000","Bronx","Crotona","Night Owl","2","2","4","6","5","11"
"2019-07-16T00:00:00.000","Bronx","Van Cortlandt","Night Owl","5","8","13","10","30","40"
"2019-07-16T00:00:00.000","Brooklyn","Sunset","Night Owl","14","20","34","46","48","94"
"2019-07-16T00:00:00.000","Brooklyn","Red Hook","Night Owl","13","15","28","30","29","59"
"2019-07-16T00:00:00.000","Brooklyn","McCarren","Night Owl","32","53","85","98","106","204"
"2019-07-16T00:00:00.000","Manhattan","Tony Dapolito","Night Owl","3","4","7","13","14","27"
"2019-07-16T00:00:00.000","Manhattan","Marcus Garvey","Night Owl","5","9","14","13","26","39"
"2019-07-16T00:00:00.000","Manhattan","Asser Levy","Night Owl","10","9","19","31","24","55"
"2019-07-16T00:00:00.000","Manhattan","Lasker","Night Owl","6","22","28","22","66","88"
"2019-07-16T00:00:00.000","Manhattan","John Jay","Night Owl","19","34","53","51","77","128"
"2019-07-16T00:00:00.000","Manhattan","Hamilton Fish","Night Owl","18","24","42","53","58","111"
"2019-07-15T00:00:00.000","Staten Island","Lyons","Night Owl","4","4","8","15","15","30"
"2019-07-15T00:00:00.000","Queens","Astoria","Night Owl","26","37","63","74","82","156"
"2019-07-15T00:00:00.000","Bronx","Crotona","Night Owl","0","0","0","3","1","4"
"2019-07-15T00:00:00.000","Bronx","Van Cortlandt","Night Owl","4","3","7","14","9","23"
"2019-07-15T00:00:00.000","Brooklyn","Sunset","Night Owl","13","24","37","36","49","85"
"2019-07-15T00:00:00.000","Brooklyn","Red Hook","Night Owl","10","15","25","34","37","71"
"2019-07-15T00:00:00.000","Brooklyn","McCarren","Night Owl","43","53","96","98","116","214"
"2019-07-15T00:00:00.000","Manhattan","Tony Dapolito","Night Owl","13","8","21","23","20","43"
"2019-07-15T00:00:00.000","Manhattan","Marcus Garvey","Night Owl","4","9","13","13","20","33"
"2019-07-15T00:00:00.000","Manhattan","Asser Levy","Night Owl","5","5","10","24","21","45"
"2019-07-15T00:00:00.000","Manhattan","Lasker","Night Owl","17","28","45","42","48","90"
"2019-07-15T00:00:00.000","Manhattan","John Jay","Night Owl","24","34","58","38","51","89"
"2019-07-15T00:00:00.000","Manhattan","Hamilton Fish","Night Owl","33","36","69","58","79","137"
"2019-07-15T00:00:00.000","Manhattan","Hamilton Fish","Night Owl","33","36","69","21","58","79"
"2019-07-12T00:00:00.000","Staten Island","Lyons","Night Owl","6","5","11","13","21","34"
"2019-07-12T00:00:00.000","Queens","Astoria","Night Owl","14","25","39","55","79","134"
"2019-07-12T00:00:00.000","Bronx","Crotona","Night Owl","0","0","0","2","1","3"
"2019-07-12T00:00:00.000","Bronx","Van Cortlandt","Night Owl","6","6","12","18","16","34"
"2019-07-12T00:00:00.000","Brooklyn","Sunset","Night Owl","3","9","12","26","30","56"
"2019-07-12T00:00:00.000","Brooklyn","Red Hook","Night Owl","9","11","20","24","35","59"
"2019-07-12T00:00:00.000","Brooklyn","McCarren","Night Owl","35","39","74","74","82","156"
"2019-07-11T00:00:00.000","Manhattan","Tony Dapolito","Night Owl","7","6","13","16","14","30"
"2019-07-11T00:00:00.000","Manhattan","Marcus Garvey","Night Owl","4","2","6","11","16","27"
"2019-07-11T00:00:00.000","Manhattan","Asser Levy","Night Owl","3","9","12","13","15","28"
"2019-07-11T00:00:00.000","Manhattan","Lasker","Night Owl","11","11","22","38","42","80"
"2019-07-12T00:00:00.000","Manhattan","John Jay","Night Owl","4","10","14","41","45","86"
"2019-07-12T00:00:00.000","Manhattan","Hamilton Fish","Night Owl","17","18","35","45","41","86"
"2019-07-11T00:00:00.000","Staten Island","Lyons","Night Owl","0","0","0","0","0","0"
"2019-07-11T00:00:00.000","Queens","Astoria","Night Owl","3","1","4","9","6","15"
"2019-07-11T00:00:00.000","Bronx","Crotona","Night Owl","0","0","0","0","0","0"
"2019-07-11T00:00:00.000","Bronx","Van Cortlandt","Night Owl","0","0","0","2","1","3"
"2019-07-11T00:00:00.000","Brooklyn","Sunset","Night Owl","1","0","1","9","1","10"
"2019-07-11T00:00:00.000","Brooklyn","Red Hook","Night Owl","2","2","4","7","4","11"
"2019-07-11T00:00:00.000","Brooklyn","McCarren","Night Owl","5","4","9","13","14","27"
"2019-07-11T00:00:00.000","Manhattan","Tony Dapolito","Night Owl","1","0","1","5","1","6"
"2019-07-11T00:00:00.000","Manhattan","Marcus Garvey","Night Owl","4","1","5","5","2","7"
"2019-07-11T00:00:00.000","Manhattan","Asser Levy","Night Owl","0","0","0","3","5","8"
"2019-07-11T00:00:00.000","Manhattan","Lasker","Night Owl","1","1","2","4","3","7"
"2019-07-11T00:00:00.000","Manhattan","John Jay","Night Owl","11","13","24","10","6","16"
"2019-07-11T00:00:00.000","Manhattan","Hamilton Fish","Night Owl","5","4","9","14","11","25"
"2019-07-10T00:00:00.000","Staten Island","Lyons","Night Owl","4","8","12","14","15","29"
"2019-07-10T00:00:00.000","Queens","Astoria","Night Owl","28","25","53","62","59","121"
"2019-07-10T00:00:00.000","Bronx","Crotona","Night Owl","1","3","4","5","5","10"
"2019-07-10T00:00:00.000","Bronx","Van Cortlandt","Night Owl","6","9","15","13","27","40"
"2019-07-10T00:00:00.000","Brooklyn","Sunset","Night Owl","6","17","23","25","41","66"
"2019-07-10T00:00:00.000","Brooklyn","Red Hook","Night Owl","16","16","32","24","25","49"
"2019-07-10T00:00:00.000","Brooklyn","McCarren","Night Owl","35","49","84","72","77","149"
"2019-07-10T00:00:00.000","Manhattan","Tony Dapolito","Night Owl","5","7","12","11","16","27"
"2019-07-10T00:00:00.000","Manhattan","Marcus Garvey","Night Owl","5","8","13","8","18","26"
"2019-07-10T00:00:00.000","Manhattan","Asser Levy","Night Owl","5","12","17","15","29","44"
"2019-07-10T00:00:00.000","Manhattan","Lasker","Night Owl","25","24","49","45","52","97"
"2019-07-10T00:00:00.000","Manhattan","John Jay","Night Owl","29","37","66","44","46","90"
"2019-07-10T00:00:00.000","Manhattan","Hamilton Fish","Night Owl","16","28","44","50","47","97"
"2019-07-09T00:00:00.000","Staten Island","Lyons","Night Owl","3","13","16","11","18","29"
"2019-07-09T00:00:00.000","Queens","Astoria","Night Owl","35","40","75","55","67","122"
"2019-07-09T00:00:00.000","Bronx","Crotona","Night Owl","4","14","18","4","14","18"
"2019-07-09T00:00:00.000","Brooklyn","Sunset","Night Owl","15","25","40","44","35","79"
"2019-07-09T00:00:00.000","Bronx","Van Cortlandt","Night Owl","10","21","31","15","33","48"
"2019-07-09T00:00:00.000","Brooklyn","Red Hook","Night Owl","28","33","61","36","40","76"
"2019-07-09T00:00:00.000","Brooklyn","McCarren","Early Bird","56","69","125","87","92","179"
"2019-07-09T00:00:00.000","Manhattan","Tony Dapolito","Night Owl","10","19","29","17","27","44"
"2019-07-09T00:00:00.000","Manhattan","Marcus Garvey","Night Owl","8","15","23","12","22","34"
"2019-07-09T00:00:00.000","Manhattan","Asser Levy","Night Owl","16","23","39","23","29","52"
"2019-07-09T00:00:00.000","Manhattan","Lasker","Night Owl","26","45","71","63","50","113"
"2019-07-09T00:00:00.000","Manhattan","John Jay","Night Owl","43","43","86","53","58","111"
"2019-07-09T00:00:00.000","Manhattan","Hamilton Fish","Night Owl","23","36","59","45","49","94"
"2019-07-08T00:00:00.000","Staten Island","Lyons","Night Owl","7","7","14","12","15","27"
"2019-07-08T00:00:00.000","Queens","Astoria","Night Owl","37","53","90","52","72","124"
"2019-07-08T00:00:00.000","Bronx","Crotona","Night Owl","2","1","3","3","6","9"
"2019-07-08T00:00:00.000","Bronx","Van Cortlandt","Night Owl","10","22","32","16","26","42"
"2019-07-08T00:00:00.000","Brooklyn","Sunset","Night Owl","28","43","71","37","51","88"
"2019-07-08T00:00:00.000","Brooklyn","Red Hook","Night Owl","10","21","31","20","27","47"
"2019-07-08T00:00:00.000","Brooklyn","McCarren","Night Owl","57","57","114","72","76","148"
"2019-07-08T00:00:00.000","Manhattan","Tony Dapolito","Night Owl","10","8","18","13","12","25"
"2019-07-08T00:00:00.000","Manhattan","Marcus Garvey","Night Owl","8","14","22","10","19","29"
"2019-07-08T00:00:00.000","Manhattan","Asser Levy","Night Owl","11","10","21","15","19","34"
"2019-07-08T00:00:00.000","Manhattan","Lasker","Night Owl","25","32","57","34","42","76"
"2019-07-08T00:00:00.000","Manhattan","John Jay","Night Owl","56","46","102","61","46","107"
"2019-07-08T00:00:00.000","Manhattan","Hamilton Fish","Night Owl","34","24","58","58","34","92"
"2019-07-05T00:00:00.000","Staten Island","Lyons","Night Owl","13","11","24","12","10","22"
"2019-07-05T00:00:00.000","Queens","Astoria","Night Owl","64","75","139","49","75","124"
"2019-07-05T00:00:00.000","Bronx","Crotona","Night Owl","3","4","7","3","4","7"
"2019-07-05T00:00:00.000","Bronx","Van Cortlandt","Night Owl","7","16","23","8","16","24"
"2019-07-05T00:00:00.000","Brooklyn","Sunset","Night Owl","27","37","64","27","37","64"
"2019-07-05T00:00:00.000","Brooklyn","Red Hook","Night Owl","23","21","44","23","21","44"
"2019-07-05T00:00:00.000","Brooklyn","McCarren","Night Owl","46","64","110","42","64","106"
"2019-07-05T00:00:00.000","Manhattan","Tony Dapolito","Night Owl","5","10","15","5","10","15"
"2019-07-05T00:00:00.000","Manhattan","Marcus Garvey","Night Owl","5","12","17","3","8","11"
"2019-07-05T00:00:00.000","Manhattan","Asser Levy","Night Owl","11","15","26","12","25","37"
"2019-07-05T00:00:00.000","Manhattan","Lasker","Night Owl","21","23","44","41","51","92"
"2019-07-05T00:00:00.000","Manhattan","John Jay","Night Owl","28","41","69","27","46","73"
"2019-07-05T00:00:00.000","Manhattan","Hamilton Fish","Night Owl","30","30","60","38","30","68"
"2019-08-30T00:00:00.000","Staten Island","Lyons","Early Bird","0","0","0","8","9","17"
"2019-08-30T00:00:00.000","Queens","Astoria","Early Bird","0","0","0","21","28","49"
"2019-08-30T00:00:00.000","Bronx","Crotona","Early Bird","0","0","0","2","2","4"
"2019-08-30T00:00:00.000","Bronx","Van Cortlandt","Early Bird","0","0","0","20","15","35"
"2019-08-30T00:00:00.000","Brooklyn","Kosciuszko","Early Bird","0","1","1","7","5","12"
"2019-08-30T00:00:00.000","Brooklyn","Red Hook","Early Bird","0","0","0","15","29","44"
"2019-08-30T00:00:00.000","Brooklyn","Sunset","Early Bird","0","0","0","26","32","58"
"2019-08-30T00:00:00.000","Brooklyn","McCarren","Early Bird","0","0","0","68","72","140"
"2019-08-30T00:00:00.000","Manhattan","Thomas Jefferson","Early Bird","0","0","0","8","7","15"
"2019-08-30T00:00:00.000","Manhattan","Tony Dapolito","Early Bird","0","0","0","13","22","35"
"2019-08-30T00:00:00.000","Manhattan","Jackie Robinson","Early Bird","0","0","0","11","20","31"
"2019-08-30T00:00:00.000","Manhattan","Asser Levy","Early Bird","0","0","0","19","23","42"
"2019-08-30T00:00:00.000","Manhattan","Lasker","Early Bird","0","5","5","27","1","28"
"2019-08-30T00:00:00.000","Manhattan","Hamilton Fish","Early Bird","0","0","0","22","30","52"
"2019-08-30T00:00:00.000","Manhattan","John Jay","Early Bird","0","0","0","30","40","70"
"2019-08-29T00:00:00.000","Staten Island","Lyons","Early Bird","0","0","0","7","8","15"
"2019-08-29T00:00:00.000","Queens","Astoria","Early Bird","1","0","1","36","34","70"
"2019-08-29T00:00:00.000","Bronx","Crotona","Early Bird","0","0","0","1","1","2"
"2019-08-29T00:00:00.000","Bronx","Van Cortlandt","Early Bird","0","0","0","18","10","28"
"2019-08-29T00:00:00.000","Brooklyn","Kosciuszko","Early Bird","2","0","2","12","6","18"
"2019-08-29T00:00:00.000","Brooklyn","Red Hook","Early Bird","0","1","1","16","22","38"
"2019-08-29T00:00:00.000","Brooklyn","Sunset","Early Bird","1","0","1","23","27","50"
"2019-08-29T00:00:00.000","Brooklyn","McCarren","Early Bird","1","2","3","49","58","107"
"2019-08-29T00:00:00.000","Manhattan","Thomas Jefferson","Early Bird","0","0","0","11","7","18"
"2019-08-29T00:00:00.000","Manhattan","Tony Dapolito","Early Bird","0","0","0","10","14","24"
"2019-08-29T00:00:00.000","Manhattan","Jackie Robinson","Early Bird","1","1","2","9","25","34"
"2019-08-29T00:00:00.000","Manhattan","Asser Levy","Early Bird","0","0","0","11","22","33"
"2019-08-29T00:00:00.000","Manhattan","John Jay","Early Bird","1","1","2","32","30","62"
"2019-08-29T00:00:00.000","Manhattan","Lasker","Early Bird","0","0","0","23","33","56"
"2019-08-29T00:00:00.000","Manhattan","Hamilton Fish","Early Bird","0","0","0","16","20","36"
"2019-08-28T00:00:00.000","Staten Island","Lyons","Early Bird","0","0","0","7","6","13"
"2019-08-28T00:00:00.000","Queens","Astoria","Early Bird","1","0","1","33","37","70"
"2019-08-28T00:00:00.000","Bronx","Crotona","Early Bird","0","0","0","0","1","1"
"2019-08-28T00:00:00.000","Bronx","Van Cortlandt","Early Bird","0","0","0","17","17","34"
"2019-08-28T00:00:00.000","Brooklyn","Kosciuszko","Early Bird","1","0","1","7","6","13"
"2019-08-28T00:00:00.000","Brooklyn","Red Hook","Early Bird","0","0","0","18","21","39"
"2019-08-28T00:00:00.000","Brooklyn","Sunset","Early Bird","1","0","1","22","26","48"
"2019-08-28T00:00:00.000","Brooklyn","McCarren","Early Bird","3","2","5","57","44","101"
"2019-08-28T00:00:00.000","Manhattan","Thomas Jefferson","Early Bird","0","0","0","9","9","18"
"2019-08-28T00:00:00.000","Manhattan","Tony Dapolito","Early Bird","0","0","0","7","12","19"
"2019-08-28T00:00:00.000","Manhattan","Jackie Robinson","Early Bird","0","0","0","8","16","24"
"2019-08-28T00:00:00.000","Manhattan","Asser Levy","Early Bird","0","0","0","18","24","42"
"2019-08-28T00:00:00.000","Manhattan","John Jay","Early Bird","2","1","3","18","33","51"
"2019-08-28T00:00:00.000","Manhattan","Lasker","Early Bird","1","1","2","22","34","56"
"2019-08-28T00:00:00.000","Manhattan","Hamilton Fish","Early Bird","0","0","0","29","32","61"
"2019-08-27T00:00:00.000","Staten Island","Lyons","Early Bird","0","0","0","4","6","10"
"2019-08-27T00:00:00.000","Queens","Astoria","Early Bird","1","1","2","34","33","67"
"2019-08-27T00:00:00.000","Bronx","Crotona","Early Bird","0","0","0","2","1","3"
"2019-08-27T00:00:00.000","Bronx","Van Cortlandt","Early Bird","0","0","0","15","7","22"
"2019-08-27T00:00:00.000","Brooklyn","Kosciuszko","Early Bird","0","0","0","8","25","33"
"2019-08-27T00:00:00.000","Brooklyn","Red Hook","Early Bird","1","0","1","15","14","29"
"2019-08-27T00:00:00.000","Brooklyn","Sunset","Early Bird","0","0","0","19","24","43"
"2019-08-27T00:00:00.000","Brooklyn","McCarren","Early Bird","1","4","5","46","59","105"
"2019-08-27T00:00:00.000","Manhattan","Thomas Jefferson","Early Bird","1","0","1","8","8","16"
"2019-08-27T00:00:00.000","Manhattan","Tony Dapolito","Early Bird","0","1","1","8","14","22"
"2019-08-27T00:00:00.000","Manhattan","Jackie Robinson","Early Bird","1","0","1","6","17","23"
"2019-08-27T00:00:00.000","Manhattan","Asser Levy","Early Bird","1","0","1","14","15","29"
"2019-08-27T00:00:00.000","Manhattan","John Jay","Early Bird","1","0","1","27","24","51"
"2019-08-27T00:00:00.000","Manhattan","Lasker","Early Bird","0","0","0","19","35","54"
"2019-08-27T00:00:00.000","Manhattan","Hamilton Fish","Early Bird","0","0","0","26","28","54"
"2019-08-26T00:00:00.000","Staten Island","Lyons","Early Bird","0","0","0","4","3","7"
"2019-08-26T00:00:00.000","Manhattan","Astoria","Early Bird","0","1","1","29","31","60"
"2019-08-26T00:00:00.000","Bronx","Crotona","Early Bird","0","0","0","1","3","4"
"2019-08-26T00:00:00.000","Bronx","Van Cortlandt","Early Bird","0","0","0","19","8","27"
"2019-08-26T00:00:00.000","Brooklyn","Kosciuszko","Early Bird","0","1","1","5","8","13"
"2019-08-26T00:00:00.000","Brooklyn","Red Hook","Early Bird","2","0","2","16","12","28"
"2019-08-26T00:00:00.000","Brooklyn","Sunset","Early Bird","0","2","2","16","25","41"
"2019-08-26T00:00:00.000","Brooklyn","McCarren","Early Bird","1","1","2","38","29","67"
"2019-08-26T00:00:00.000","Manhattan","Thomas Jefferson","Early Bird","1","2","3","10","7","17"
"2019-08-26T00:00:00.000","Manhattan","Tony Dapolito","Early Bird","0","0","0","5","11","16"
"2019-08-26T00:00:00.000","Manhattan","Jackie Robinson","Early Bird","0","0","0","7","16","23"
"2019-08-26T00:00:00.000","Manhattan","Asser Levy","Early Bird","0","2","2","16","17","33"
"2019-08-26T00:00:00.000","Manhattan","John Jay","Early Bird","2","2","4","20","25","45"
"2019-08-26T00:00:00.000","Manhattan","Lasker","Early Bird","2","0","2","15","22","37"
"2019-08-26T00:00:00.000","Manhattan","Hamilton Fish","Early Bird","1","0","1","20","22","42"
"2019-08-23T00:00:00.000","Staten Island","Lyons","Early Bird","0","0","0","6","11","17"
"2019-08-23T00:00:00.000","Queens","Astoria","Early Bird","0","1","1","36","36","72"
"2019-08-23T00:00:00.000","Bronx","Crotona","Early Bird","0","0","0","3","2","5"
"2019-08-23T00:00:00.000","Bronx","Van Cortlandt","Early Bird","0","0","0","0","0","0"
"2019-08-23T00:00:00.000","Brooklyn","Kosciuszko","Early Bird","0","0","0","8","6","14"
"2019-08-23T00:00:00.000","Brooklyn","Sunset","Early Bird","0","0","0","0","0","0"
"2019-08-23T00:00:00.000","Brooklyn","Red Hook","Early Bird","1","2","3","13","22","35"
"2019-08-23T00:00:00.000","Brooklyn","McCarren","Early Bird","2","1","3","56","38","94"
"2019-08-23T00:00:00.000","Manhattan","Thomas Jefferson","Early Bird","0","0","0","6","5","11"
"2019-08-23T00:00:00.000","Manhattan","Tony Dapolito","Early Bird","0","0","0","13","9","22"
"2019-08-23T00:00:00.000","Manhattan","Jackie Robinson","Early Bird","0","0","0","12","21","33"
"2019-08-23T00:00:00.000","Manhattan","Asser Levy","Early Bird","0","1","1","14","20","34"
"2019-08-23T00:00:00.000","Manhattan","John Jay","Early Bird","3","3","6","22","27","49"
"2019-08-23T00:00:00.000","Manhattan","Lasker","Early Bird","0","1","1","25","33","58"
"2019-08-23T00:00:00.000","Manhattan","Hamilton Fish","Early Bird","1","0","1","29","37","66"
"2019-08-22T00:00:00.000","Staten Island","Lyons","Early Bird","0","0","0","8","8","16"
"2019-08-22T00:00:00.000","Queens","Astoria","Early Bird","1","3","4","49","50","99"
"2019-08-22T00:00:00.000","Bronx","Crotona","Early Bird","0","0","0","4","1","5"
"2019-08-22T00:00:00.000","Bronx","Van Cortlandt","Early Bird","0","0","0","17","9","26"
"2019-08-22T00:00:00.000","Brooklyn","Kosciuszko","Early Bird","2","3","5","14","19","33"
"2019-08-22T00:00:00.000","Brooklyn","Red Hook","Early Bird","0","0","0","15","16","31"
"2019-08-22T00:00:00.000","Brooklyn","Sunset","Early Bird","1","2","3","22","26","48"
"2019-08-22T00:00:00.000","Brooklyn","McCarren","Early Bird","7","6","13","74","59","133"
"2019-08-22T00:00:00.000","Manhattan","Thomas Jefferson","Early Bird","0","0","0","12","11","23"
"2019-08-22T00:00:00.000","Manhattan","Tony Dapolito","Early Bird","0","1","1","10","15","25"
"2019-08-22T00:00:00.000","Manhattan","Jackie Robinson","Early Bird","0","2","2","8","25","33"
"2019-08-22T00:00:00.000","Manhattan","Asser Levy","Early Bird","2","1","3","17","24","41"
"2019-08-22T00:00:00.000","Manhattan","John Jay","Early Bird","1","3","4","34","39","73"
"2019-08-22T00:00:00.000","Manhattan","Lasker","Early Bird","6","6","12","35","42","77"
"2019-08-22T00:00:00.000","Manhattan","Hamilton Fish","Early Bird","1","1","2","41","38","79"
"2019-08-21T00:00:00.000","Staten Island","Lyons","Early Bird","0","0","0","9","8","17"
"2019-08-21T00:00:00.000","Queens","Astoria","Early Bird","1","0","1","4","35","39"
"2019-08-21T00:00:00.000","Bronx","Crotona","Early Bird","0","0","0","3","4","7"
"2019-08-21T00:00:00.000","Bronx","Van Cortlandt","Early Bird","3","0","3","23","10","33"
"2019-08-21T00:00:00.000","Brooklyn","Kosciuszko","Early Bird","1","3","4","10","4","14"
"2019-08-21T00:00:00.000","Brooklyn","Red Hook","Early Bird","0","1","1","18","19","37"
"2019-08-21T00:00:00.000","Brooklyn","Sunset","Early Bird","0","0","0","29","30","59"
"2019-08-21T00:00:00.000","Brooklyn","McCarren","Early Bird","1","4","5","65","72","137"
"2019-08-21T00:00:00.000","Manhattan","Thomas Jefferson","Early Bird","0","0","0","9","8","17"
"2019-08-21T00:00:00.000","Manhattan","Tony Dapolito","Early Bird","1","1","2","9","17","26"
"2019-08-21T00:00:00.000","Manhattan","Jackie Robinson","Early Bird","0","0","0","14","25","39"
"2019-08-21T00:00:00.000","Manhattan","Asser Levy","Early Bird","0","0","0","14","25","39"
"2019-08-21T00:00:00.000","Manhattan","John Jay","Early Bird","3","0","3","33","37","70"
"2019-08-21T00:00:00.000","Manhattan","Lasker","Early Bird","3","2","5","31","40","71"
"2019-08-21T00:00:00.000","Manhattan","Hamilton Fish","Early Bird","0","2","2","37","50","87"
"2019-08-20T00:00:00.000","Staten Island","Lyons","Early Bird","1","0","1","9","8","17"
"2019-08-20T00:00:00.000","Queens","Astoria","Early Bird","0","1","1","49","63","112"
"2019-08-20T00:00:00.000","Bronx","Crotona","Early Bird","0","0","0","1","2","3"
"2019-08-20T00:00:00.000","Bronx","Van Cortlandt","Early Bird","1","0","1","21","17","38"
"2019-08-20T00:00:00.000","Brooklyn","Kosciuszko","Early Bird","0","0","0","0","0","0"
"2019-08-20T00:00:00.000","Brooklyn","Red Hook","Early Bird","2","1","3","26","23","49"
"2019-08-20T00:00:00.000","Brooklyn","Sunset","Early Bird","0","2","2","29","39","68"
"2019-08-20T00:00:00.000","Brooklyn","McCarren","Early Bird","4","5","9","76","72","148"
"2019-08-20T00:00:00.000","Manhattan","Thomas Jefferson","Early Bird","0","0","0","8","11","19"
"2019-08-20T00:00:00.000","Manhattan","Tony Dapolito","Early Bird","0","0","0","12","15","27"
"2019-08-20T00:00:00.000","Manhattan","Jackie Robinson","Early Bird","0","1","1","10","21","31"
"2019-08-20T00:00:00.000","Manhattan","Asser Levy","Early Bird","0","1","1","11","22","33"
"2019-08-20T00:00:00.000","Manhattan","John Jay","Early Bird","2","3","5","35","35","70"
"2019-08-20T00:00:00.000","Manhattan","Lasker","Early Bird","2","1","3","29","22","51"
"2019-08-20T00:00:00.000","Manhattan","Hamilton Fish","Early Bird","1","3","4","45","36","81"
"2019-08-19T00:00:00.000","Staten Island","Lyons","Early Bird","0","0","0","9","9","18"
"2019-08-19T00:00:00.000","Queens","Astoria","Early Bird","0","9","9","38","48","86"
"2019-08-19T00:00:00.000","Bronx","Crotona","Early Bird","0","0","0","2","2","4"
"2019-08-19T00:00:00.000","Bronx","Van Cortlandt","Early Bird","1","1","2","25","19","44"
"2019-08-19T00:00:00.000","Brooklyn","Kosciuszko","Early Bird","1","1","2","7","12","19"
"2019-08-19T00:00:00.000","Brooklyn","Red Hook","Early Bird","0","4","4","20","31","51"
"2019-08-19T00:00:00.000","Brooklyn","Sunset","Early Bird","3","1","4","34","34","68"
"2019-08-19T00:00:00.000","Brooklyn","McCarren","Early Bird","2","5","7","66","73","139"
"2019-08-19T00:00:00.000","Manhattan","Thomas Jefferson","Early Bird","1","0","1","7","11","18"
"2019-08-19T00:00:00.000","Manhattan","Tony Dapolito","Early Bird","1","1","2","9","19","28"
"2019-08-19T00:00:00.000","Manhattan","Jackie Robinson","Early Bird","0","1","1","11","30","41"
"2019-08-19T00:00:00.000","Manhattan","Asser Levy","Early Bird","2","0","2","22","30","52"
"2019-08-19T00:00:00.000","Manhattan","John Jay","Early Bird","4","6","10","29","40","69"
"2019-08-19T00:00:00.000","Manhattan","Lasker","Early Bird","3","3","6","31","45","76"
"2019-08-19T00:00:00.000","Manhattan","Hamilton Fish","Early Bird","0","0","0","44","49","93"
"2019-08-16T00:00:00.000","Staten Island","Lyons","Early Bird","2","1","3","12","7","19"
"2019-08-16T00:00:00.000","Queens","Astoria","Early Bird","2","0","2","41","44","85"
"2019-08-16T00:00:00.000","Bronx","Crotona","Early Bird","0","0","0","2","1","3"
"2019-08-16T00:00:00.000","Bronx","Van Cortlandt","Early Bird","1","1","2","24","21","45"
"2019-08-16T00:00:00.000","Brooklyn","Kosciuszko","Early Bird","2","2","4","12","12","24"
"2019-08-16T00:00:00.000","Brooklyn","Red Hook","Early Bird","1","0","1","0","0","0"
"2019-08-16T00:00:00.000","Manhattan","Sunset","Early Bird","1","0","1","28","38","66"
"2019-08-16T00:00:00.000","Brooklyn","McCarren","Early Bird","2","0","2","54","52","106"
"2019-08-16T00:00:00.000","Manhattan","Thomas Jefferson","Early Bird","0","1","1","9","12","21"
"2019-08-16T00:00:00.000","Manhattan","Tony Dapolito","Early Bird","0","0","0","9","20","29"
"2019-08-16T00:00:00.000","Manhattan","Jackie Robinson","Early Bird","0","2","2","17","25","42"
"2019-08-16T00:00:00.000","Manhattan","Asser Levy","Early Bird","0","0","0","16","25","41"
"2019-08-16T00:00:00.000","Manhattan","John Jay","Early Bird","1","2","3","25","38","63"
"2019-08-16T00:00:00.000","Manhattan","Lasker","Early Bird","1","1","2","28","45","73"
"2019-08-16T00:00:00.000","Manhattan","Hamilton Fish","Early Bird","1","4","5","38","41","79"
"2019-08-15T00:00:00.000","Staten Island","Lyons","Early Bird","0","0","0","6","9","15"
"2019-08-15T00:00:00.000","Queens","Astoria","Early Bird","0","1","1","52","42","94"
"2019-08-15T00:00:00.000","Bronx","Crotona","Early Bird","0","1","1","2","3","5"
"2019-08-15T00:00:00.000","Bronx","Van Cortlandt","Early Bird","0","1","1","15","14","29"
"2019-08-15T00:00:00.000","Brooklyn","Kosciuszko","Early Bird","0","2","2","11","16","27"
"2019-08-15T00:00:00.000","Brooklyn","Red Hook","Early Bird","0","2","2","13","22","35"
"2019-08-15T00:00:00.000","Brooklyn","Sunset","Early Bird","1","0","1","25","32","57"
"2019-08-15T00:00:00.000","Brooklyn","McCarren","Early Bird","3","1","4","58","60","118"
"2019-08-15T00:00:00.000","Manhattan","Thomas Jefferson","Early Bird","0","0","0","8","6","14"
"2019-08-15T00:00:00.000","Manhattan","Tony Dapolito","Early Bird","0","1","1","9","17","26"
"2019-08-15T00:00:00.000","Manhattan","Jackie Robinson","Early Bird","0","0","0","11","27","38"
"2019-08-15T00:00:00.000","Manhattan","Asser Levy","Early Bird","0","0","0","15","18","33"
"2019-08-15T00:00:00.000","Manhattan","John Jay","Early Bird","1","2","3","30","36","66"
"2019-08-15T00:00:00.000","Manhattan","Lasker","Early Bird","2","1","3","25","45","70"
"2019-08-15T00:00:00.000","Manhattan","Hamilton Fish","Early Bird","2","1","3","40","41","81"
"2019-08-14T00:00:00.000","Staten Island","Lyons","Early Bird","1","1","2","8","15","23"
"2019-08-14T00:00:00.000","Queens","Astoria","Early Bird","1","1","2","45","38","83"
"2019-08-14T00:00:00.000","Bronx","Crotona","Early Bird","0","0","0","3","3","6"
"2019-08-14T00:00:00.000","Bronx","Van Cortlandt","Early Bird","5","0","5","19","13","32"
"2019-08-14T00:00:00.000","Brooklyn","Kosciuszko","Early Bird","2","3","5","13","16","29"
"2019-08-14T00:00:00.000","Brooklyn","Red Hook","Early Bird","0","0","0","23","15","38"
"2019-08-14T00:00:00.000","Brooklyn","Sunset","Early Bird","1","0","1","29","35","64"
"2019-08-14T00:00:00.000","Brooklyn","McCarren","Early Bird","4","2","6","67","58","125"
"2019-08-14T00:00:00.000","Manhattan","Thomas Jefferson","Early Bird","0","0","0","12","12","24"
"2019-08-14T00:00:00.000","Manhattan","Tony Dapolito","Early Bird","0","0","0","11","15","26"
"2019-08-14T00:00:00.000","Manhattan","Jackie Robinson","Early Bird","1","1","2","14","28","42"
"2019-08-14T00:00:00.000","Manhattan","Asser Levy","Early Bird","0","0","0","18","22","40"
"2019-08-14T00:00:00.000","Manhattan","John Jay","Early Bird","2","0","2","25","26","51"
"2019-08-14T00:00:00.000","Manhattan","Lasker","Early Bird","3","1","4","28","36","64"
"2019-08-14T00:00:00.000","Manhattan","Hamilton Fish","Early Bird","2","2","4","46","47","93"
"2019-08-13T00:00:00.000","Staten Island","Lyons","Early Bird","0","0","0","4","7","11"
"2019-08-13T00:00:00.000","Queens","Astoria","Early Bird","1","0","1","42","38","80"
"2019-08-13T00:00:00.000","Bronx","Crotona","Early Bird","0","0","0","1","2","3"
"2019-08-13T00:00:00.000","Bronx","Van Cortlandt","Early Bird","0","0","0","14","10","24"
"2019-08-13T00:00:00.000","Brooklyn","Kosciuszko","Early Bird","1","0","1","7","10","17"
"2019-08-13T00:00:00.000","Brooklyn","Red Hook","Early Bird","4","2","6","19","24","43"
"2019-08-13T00:00:00.000","Brooklyn","Sunset","Early Bird","2","3","5","27","36","63"
"2019-08-13T00:00:00.000","Brooklyn","McCarren","Early Bird","2","2","4","48","53","101"
"2019-08-13T00:00:00.000","Manhattan","Thomas Jefferson","Early Bird","0","0","0","10","18","28"
"2019-08-13T00:00:00.000","Manhattan","Tony Dapolito","Early Bird","0","0","0","10","21","31"
"2019-08-13T00:00:00.000","Manhattan","Jackie Robinson","Early Bird","1","0","1","9","16","25"
"2019-08-13T00:00:00.000","Manhattan","Asser Levy","Early Bird","0","0","0","17","16","33"
"2019-08-13T00:00:00.000","Manhattan","John Jay","Early Bird","0","2","2","26","25","51"
"2019-08-13T00:00:00.000","Manhattan","Lasker","Early Bird","3","0","3","36","31","67"
"2019-08-13T00:00:00.000","Manhattan","Hamilton Fish","Early Bird","2","2","4","34","31","65"
"2019-08-12T00:00:00.000","Staten Island","Lyons","Early Bird","0","0","0","7","9","16"
"2019-08-12T00:00:00.000","Queens","Astoria","Early Bird","2","2","4","52","43","95"
"2019-08-12T00:00:00.000","Bronx","Crotona","Early Bird","1","1","2","2","3","5"
"2019-08-12T00:00:00.000","Bronx","Van Cortlandt","Early Bird","0","0","0","19","15","34"
"2019-08-12T00:00:00.000","Brooklyn","Kosciuszko","Early Bird","2","1","3","13","14","27"
"2019-08-12T00:00:00.000","Brooklyn","Red Hook","Early Bird","2","5","7","27","22","49"
"2019-08-12T00:00:00.000","Brooklyn","Sunset","Early Bird","4","2","6","37","38","75"
"2019-08-12T00:00:00.000","Brooklyn","McCarren","Early Bird","6","4","10","60","60","120"
"2019-08-12T00:00:00.000","Manhattan","Thomas Jefferson","Early Bird","0","0","0","12","14","26"
"2019-08-12T00:00:00.000","Manhattan","Tony Dapolito","Early Bird","0","1","1","10","15","25"
"2019-08-12T00:00:00.000","Manhattan","Jackie Robinson","Early Bird","2","3","5","26","16","42"
"2019-08-12T00:00:00.000","Manhattan","Asser Levy","Early Bird","2","0","2","15","23","38"
"2019-08-12T00:00:00.000","Manhattan","John Jay","Early Bird","8","7","15","32","37","69"
"2019-08-12T00:00:00.000","Manhattan","Lasker","Early Bird","4","2","6","29","43","72"
"2019-08-12T00:00:00.000","Manhattan","Hamilton Fish","Early Bird","1","5","6","40","48","88"
"2019-08-09T00:00:00.000","Staten Island","Lyons","Early Bird","0","0","0","7","7","14"
"2019-08-09T00:00:00.000","Queens","Astoria","Early Bird","3","2","5","50","45","95"
"2019-08-09T00:00:00.000","Bronx","Crotona","Early Bird","0","0","0","3","3","6"
"2019-08-09T00:00:00.000","Bronx","Van Cortlandt","Early Bird","2","3","5","24","21","45"
"2019-08-09T00:00:00.000","Brooklyn","Kosciuszko","Early Bird","0","1","1","17","17","34"
"2019-08-09T00:00:00.000","Brooklyn","Red Hook","Early Bird","4","1","5","23","26","49"
"2019-08-09T00:00:00.000","Brooklyn","Sunset","Early Bird","0","2","2","33","40","73"
"2019-08-09T00:00:00.000","Brooklyn","McCarren","Early Bird","10","2","12","82","76","158"
"2019-08-09T00:00:00.000","Manhattan","Thomas Jefferson","Early Bird","0","0","0","10","6","16"
"2019-08-09T00:00:00.000","Manhattan","Tony Dapolito","Early Bird","0","0","0","11","16","27"
"2019-08-09T00:00:00.000","Manhattan","Jackie Robinson","Early Bird","3","0","3","13","30","43"
"2019-08-09T00:00:00.000","Manhattan","Asser Levy","Early Bird","1","0","1","17","25","42"
"2019-08-09T00:00:00.000","Manhattan","John Jay","Early Bird","0","1","1","25","46","71"
"2019-08-09T00:00:00.000","Manhattan","Lasker","Early Bird","4","5","9","46","54","100"
"2019-08-09T00:00:00.000","Manhattan","Hamilton Fish","Early Bird","0","0","0","48","58","106"
"2019-08-07T00:00:00.000","Brooklyn","Kosciuszko","Early Bird","2","4","6","12","10","22"
"2019-08-06T00:00:00.000","Brooklyn","Kosciuszko","Early Bird","3","1","4","10","28","38"
"2019-08-05T00:00:00.000","Brooklyn","Kosciuszko","Early Bird","2","2","4","18","15","33"
"2019-08-02T00:00:00.000","Brooklyn","Kosciuszko","Early Bird","4","3","7","22","17","39"
"2019-08-01T00:00:00.000","Brooklyn","Kosciuszko","Early Bird","2","4","6","13","19","32"
"2019-07-31T00:00:00.000","Brooklyn","Kosciuszko","Early Bird","3","5","8","13","19","32"
"2019-07-30T00:00:00.000","Brooklyn","Kosciuszko","Early Bird","3","11","14","15","25","40"
"2019-07-29T00:00:00.000","Brooklyn","Kosciuszko","Early Bird","3","4","7","14","20","34"
"2019-07-26T00:00:00.000","Brooklyn","Kosciuszko","Early Bird","4","5","9","18","17","35"
"2019-07-25T00:00:00.000","Brooklyn","Kosciuszko","Early Bird","7","1","8","16","13","29"
"2019-07-24T00:00:00.000","Brooklyn","Kosciuszko","Early Bird","4","7","11","15","20","35"
"2019-07-23T00:00:00.000","Brooklyn","Kosciuszko","Early Bird","2","3","5","3","6","9"
"2019-07-22T00:00:00.000","Brooklyn","Kosciuszko","Early Bird","4","11","15","16","19","35"
"2019-07-19T00:00:00.000","Brooklyn","Kosciuszko","Early Bird","2","1","3","10","8","18"
"2019-07-18T00:00:00.000","Brooklyn","Kosciuszko","Early Bird","1","3","4","1","3","4"
"2019-07-17T00:00:00.000","Brooklyn","Kosciuszko","Early Bird","6","6","12","15","15","30"
"2019-07-16T00:00:00.000","Brooklyn","Kosciuszko","Early Bird","4","16","20","21","26","47"
"2019-07-15T00:00:00.000","Brooklyn","Kosciuszko","Early Bird","6","9","15","13","17","30"
"2019-07-12T00:00:00.000","Brooklyn","Kosciuszko","Early Bird","8","9","17","19","16","35"
"2019-07-11T00:00:00.000","Brooklyn","Kosciuszko","Early Bird","7","6","13","13","16","29"
"2019-07-10T00:00:00.000","Brooklyn","Kosciuszko","Early Bird","10","16","26","14","23","37"
"2019-07-09T00:00:00.000","Brooklyn","Kosciuszko","Early Bird","13","20","33","16","25","41"
"2019-07-08T00:00:00.000","Brooklyn","Kosciuszko","Early Bird","9","8","17","10","10","20"
"2019-07-05T00:00:00.000","Brooklyn","Kosciuszko","Early Bird","10","12","22","10","12","22"
"2019-08-08T00:00:00.000","Brooklyn","Kosciuszko","Early Bird","3","5","8","12","17","29"
"2019-08-08T00:00:00.000","Staten Island","Lyons","Early Bird","0","0","0","7","6","13"
"2019-08-08T00:00:00.000","Queens","Astoria","Early Bird","0","4","4","46","45","91"
"2019-08-08T00:00:00.000","Bronx","Crotona","Early Bird","0","0","0","2","1","3"
"2019-08-08T00:00:00.000","Bronx","Van Cortlandt","Early Bird","1","3","4","17","17","34"
"2019-08-08T00:00:00.000","Brooklyn","Red Hook","Early Bird","1","0","1","18","20","38"
"2019-08-08T00:00:00.000","Brooklyn","Sunset","Early Bird","1","1","2","26","32","58"
"2019-08-08T00:00:00.000","Brooklyn","McCarren","Early Bird","3","8","11","57","55","112"
"2019-08-08T00:00:00.000","Manhattan","Thomas Jefferson","Early Bird","0","1","1","10","13","23"
"2019-08-08T00:00:00.000","Manhattan","Tony Dapolito","Early Bird","0","1","1","7","19","26"
"2019-08-08T00:00:00.000","Manhattan","Jackie Robinson","Early Bird","0","1","1","11","25","36"
"2019-08-08T00:00:00.000","Manhattan","Asser Levy","Early Bird","0","1","1","11","18","29"
"2019-08-08T00:00:00.000","Manhattan","John Jay","Early Bird","1","0","1","23","32","55"
"2019-08-08T00:00:00.000","Manhattan","Lasker","Early Bird","1","1","2","35","40","75"
"2019-08-08T00:00:00.000","Manhattan","Hamilton Fish","Early Bird","4","3","7","38","49","87"
"2019-08-07T00:00:00.000","Staten Island","Lyons","Early Bird","0","0","0","1","6","7"
"2019-08-07T00:00:00.000","Queens","Astoria","Early Bird","0","7","7","49","43","92"
"2019-08-07T00:00:00.000","Bronx","Crotona","Early Bird","0","0","0","1","3","4"
"2019-08-07T00:00:00.000","Bronx","Van Cortlandt","Early Bird","1","1","2","17","13","30"
"2019-08-07T00:00:00.000","Brooklyn","Red Hook","Early Bird","2","1","3","16","18","34"
"2019-08-07T00:00:00.000","Brooklyn","Sunset","Early Bird","2","2","4","15","21","36"
"2019-08-07T00:00:00.000","Brooklyn","McCarren","Early Bird","7","4","11","63","51","114"
"2019-08-07T00:00:00.000","Manhattan","Thomas Jefferson","Early Bird","0","0","0","11","11","22"
"2019-08-07T00:00:00.000","Manhattan","Tony Dapolito","Early Bird","1","0","1","13","23","36"
"2019-08-07T00:00:00.000","Manhattan","Jackie Robinson","Early Bird","2","0","2","15","21","36"
"2019-08-07T00:00:00.000","Manhattan","Asser Levy","Early Bird","0","2","2","13","26","39"
"2019-08-07T00:00:00.000","Manhattan","John Jay","Early Bird","0","2","2","31","40","71"
"2019-08-07T00:00:00.000","Manhattan","Lasker","Early Bird","7","8","15","32","50","82"
"2019-08-07T00:00:00.000","Manhattan","Hamilton Fish","Early Bird","1","0","1","27","34","61"
"2019-08-06T00:00:00.000","Staten Island","Lyons","Early Bird","0","0","0","8","7","15"
"2019-08-06T00:00:00.000","Queens","Astoria","Early Bird","1","4","5","49","36","85"
"2019-08-06T00:00:00.000","Bronx","Crotona","Early Bird","0","0","0","2","3","5"
"2019-08-06T00:00:00.000","Bronx","Van Cortlandt","Early Bird","0","1","1","14","10","24"
"2019-08-06T00:00:00.000","Brooklyn","Red Hook","Early Bird","0","0","0","0","0","0"
"2019-08-06T00:00:00.000","Brooklyn","Sunset","Early Bird","0","0","0","0","0","0"
"2019-08-06T00:00:00.000","Brooklyn","McCarren","Early Bird","9","4","13","71","79","150"
"2019-08-06T00:00:00.000","Manhattan","Thomas Jefferson","Early Bird","1","2","3","14","12","26"
"2019-08-06T00:00:00.000","Manhattan","Tony Dapolito","Early Bird","1","0","1","13","22","35"
"2019-08-06T00:00:00.000","Manhattan","Jackie Robinson","Early Bird","2","3","5","15","31","46"
"2019-08-06T00:00:00.000","Manhattan","Asser Levy","Early Bird","1","0","1","23","20","43"
"2019-08-06T00:00:00.000","Manhattan","John Jay","Early Bird","0","0","0","28","31","59"
"2019-08-06T00:00:00.000","Manhattan","Lasker","Early Bird","5","4","9","38","36","74"
"2019-08-06T00:00:00.000","Manhattan","Hamilton Fish","Early Bird","2","6","8","43","57","100"
"2019-08-05T00:00:00.000","Staten Island","Lyons","Early Bird","0","0","0","10","8","18"
"2019-08-05T00:00:00.000","Queens","Astoria","Early Bird","6","2","8","56","36","92"
"2019-08-05T00:00:00.000","Bronx","Crotona","Early Bird","0","0","0","0","2","2"
"2019-08-05T00:00:00.000","Bronx","Van Cortlandt","Early Bird","2","2","4","22","20","42"
"2019-08-05T00:00:00.000","Brooklyn","Red Hook","Early Bird","2","1","3","18","27","45"
"2019-08-05T00:00:00.000","Brooklyn","Sunset","Early Bird","3","2","5","33","37","70"
"2019-08-05T00:00:00.000","Brooklyn","McCarren","Early Bird","4","6","10","62","76","138"
"2019-08-05T00:00:00.000","Manhattan","Thomas Jefferson","Early Bird","0","2","2","9","12","21"
"2019-08-05T00:00:00.000","Manhattan","Tony Dapolito","Early Bird","2","2","4","8","26","34"
"2019-08-05T00:00:00.000","Manhattan","Jackie Robinson","Early Bird","1","3","4","12","28","40"
"2019-08-05T00:00:00.000","Manhattan","Asser Levy","Early Bird","1","1","2","19","23","42"
"2019-08-05T00:00:00.000","Manhattan","John Jay","Early Bird","1","3","4","30","39","69"
"2019-08-05T00:00:00.000","Manhattan","Lasker","Early Bird","9","11","20","37","50","87"
"2019-08-05T00:00:00.000","Manhattan","Hamilton Fish","Early Bird","0","0","0","0","0","0"
"2019-08-02T00:00:00.000","Staten Island","Lyons","Early Bird","2","0","2","16","7","23"
"2019-08-02T00:00:00.000","Queens","Astoria","Early Bird","2","3","5","67","60","127"
"2019-08-02T00:00:00.000","Bronx","Crotona","Early Bird","0","0","0","3","4","7"
"2019-08-02T00:00:00.000","Bronx","Van Cortlandt","Early Bird","1","1","2","22","22","44"
"2019-08-02T00:00:00.000","Brooklyn","Red Hook","Early Bird","2","4","6","28","40","68"
"2019-08-02T00:00:00.000","Brooklyn","Sunset","Early Bird","1","3","4","38","46","84"
"2019-08-02T00:00:00.000","Brooklyn","McCarren","Early Bird","0","5","5","66","79","145"
"2019-08-02T00:00:00.000","Manhattan","Thomas Jefferson","Early Bird","2","0","2","11","11","22"
"2019-08-02T00:00:00.000","Manhattan","Tony Dapolito","Early Bird","0","3","3","13","23","36"
"2019-08-02T00:00:00.000","Manhattan","Jackie Robinson","Early Bird","0","2","2","17","32","49"
"2019-08-02T00:00:00.000","Manhattan","Asser Levy","Early Bird","3","0","3","23","23","46"
"2019-08-02T00:00:00.000","Manhattan","John Jay","Early Bird","2","2","4","35","39","74"
"2019-08-02T00:00:00.000","Manhattan","Lasker","Early Bird","4","3","7","38","55","93"
"2019-08-02T00:00:00.000","Manhattan","Hamilton Fish","Early Bird","0","0","0","58","60","118"
"2019-08-01T00:00:00.000","Staten Island","Lyons","Early Bird","2","1","3","14","10","24"
"2019-08-01T00:00:00.000","Queens","Astoria","Early Bird","2","1","3","63","45","108"
"2019-08-01T00:00:00.000","Bronx","Crotona","Early Bird","0","0","0","3","3","6"
"2019-08-01T00:00:00.000","Bronx","Van Cortlandt","Early Bird","1","1","2","19","20","39"
"2019-08-01T00:00:00.000","Brooklyn","Red Hook","Early Bird","0","0","0","33","30","63"
"2019-08-01T00:00:00.000","Brooklyn","Sunset","Early Bird","1","2","3","29","29","58"
"2019-08-01T00:00:00.000","Brooklyn","McCarren","Early Bird","5","4","9","66","97","163"
"2019-08-01T00:00:00.000","Manhattan","Thomas Jefferson","Early Bird","0","0","0","9","22","31"
"2019-08-01T00:00:00.000","Manhattan","Tony Dapolito","Early Bird","0","0","0","12","12","24"
"2019-08-01T00:00:00.000","Manhattan","Jackie Robinson","Early Bird","2","3","5","17","39","56"
"2019-08-01T00:00:00.000","Manhattan","Asser Levy","Early Bird","0","3","3","17","39","56"
"2019-08-01T00:00:00.000","Manhattan","John Jay","Early Bird","2","6","8","37","38","75"
"2019-08-01T00:00:00.000","Manhattan","Lasker","Early Bird","0","2","2","31","42","73"
"2019-08-01T00:00:00.000","Manhattan","Hamilton Fish","Early Bird","4","7","11","55","57","112"
"2019-07-31T00:00:00.000","Staten Island","Lyons","Early Bird","1","0","1","13","15","28"
"2019-07-31T00:00:00.000","Queens","Astoria","Early Bird","5","5","10","60","55","115"
"2019-07-31T00:00:00.000","Bronx","Crotona","Early Bird","0","0","0","0","4","4"
"2019-07-31T00:00:00.000","Bronx","Van Cortlandt","Early Bird","0","0","0","18","21","39"
"2019-07-31T00:00:00.000","Brooklyn","Sunset","Early Bird","4","2","6","40","39","79"
"2019-07-31T00:00:00.000","Brooklyn","Red Hook","Early Bird","2","6","8","25","39","64"
"2019-07-31T00:00:00.000","Brooklyn","McCarren","Early Bird","11","11","22","65","90","155"
"2019-07-31T00:00:00.000","Manhattan","Tony Dapolito","Early Bird","4","5","9","19","25","44"
"2019-07-31T00:00:00.000","Manhattan","Thomas Jefferson","Early Bird","1","0","1","18","9","27"
"2019-07-31T00:00:00.000","Manhattan","Jackie Robinson","Early Bird","1","2","3","13","32","45"
"2019-07-31T00:00:00.000","Manhattan","Asser Levy","Early Bird","2","0","2","21","29","50"
"2019-07-31T00:00:00.000","Manhattan","Lasker","Early Bird","5","3","8","40","50","90"
"2019-07-31T00:00:00.000","Manhattan","John Jay","Early Bird","4","4","8","35","37","72"
"2019-07-31T00:00:00.000","Manhattan","Hamilton Fish","Early Bird","7","4","11","74","64","138"
"2019-07-30T00:00:00.000","Staten Island","Lyons","Early Bird","2","2","4","13","11","24"
"2019-07-30T00:00:00.000","Queens","Astoria","Early Bird","4","3","7","64","57","121"
"2019-07-30T00:00:00.000","Bronx","Crotona","Early Bird","0","1","1","2","3","5"
"2019-07-30T00:00:00.000","Bronx","Van Cortlandt","Early Bird","2","6","8","19","20","39"
"2019-07-30T00:00:00.000","Brooklyn","Sunset","Early Bird","2","1","3","36","37","73"
"2019-07-30T00:00:00.000","Brooklyn","Red Hook","Early Bird","7","4","11","30","45","75"
"2019-07-30T00:00:00.000","Brooklyn","McCarren","Early Bird","5","16","21","85","91","176"
"2019-07-30T00:00:00.000","Manhattan","Tony Dapolito","Early Bird","2","1","3","15","19","34"
"2019-07-30T00:00:00.000","Manhattan","Thomas Jefferson","Early Bird","3","3","6","18","16","34"
"2019-07-30T00:00:00.000","Manhattan","Jackie Robinson","Early Bird","3","4","7","14","33","47"
"2019-07-30T00:00:00.000","Manhattan","Asser Levy","Early Bird","2","0","2","22","28","50"
"2019-07-30T00:00:00.000","Manhattan","Lasker","Early Bird","8","4","12","45","46","91"
"2019-07-30T00:00:00.000","Manhattan","John Jay","Early Bird","1","4","5","33","48","81"
"2019-07-30T00:00:00.000","Manhattan","Hamilton Fish","Early Bird","2","5","7","55","69","124"
"2019-07-29T00:00:00.000","Staten Island","Lyons","Early Bird","4","0","4","15","9","24"
"2019-07-29T00:00:00.000","Queens","Astoria","Early Bird","3","8","11","58","62","120"
"2019-07-29T00:00:00.000","Bronx","Crotona","Early Bird","1","1","2","2","3","5"
"2019-07-29T00:00:00.000","Bronx","Van Cortlandt","Early Bird","2","1","3","21","18","39"
"2019-07-29T00:00:00.000","Brooklyn","Sunset","Early Bird","1","7","8","38","48","86"
"2019-07-29T00:00:00.000","Brooklyn","Red Hook","Early Bird","4","5","9","27","33","60"
"2019-07-29T00:00:00.000","Brooklyn","McCarren","Early Bird","9","14","23","77","93","170"
"2019-07-29T00:00:00.000","Manhattan","Tony Dapolito","Early Bird","1","2","3","14","18","32"
"2019-07-29T00:00:00.000","Manhattan","Thomas Jefferson","Early Bird","1","3","4","10","18","28"
"2019-07-29T00:00:00.000","Manhattan","Jackie Robinson","Early Bird","4","6","10","19","32","51"
"2019-07-29T00:00:00.000","Manhattan","Asser Levy","Early Bird","2","0","2","17","25","42"
"2019-07-29T00:00:00.000","Manhattan","Lasker","Early Bird","7","7","14","36","54","90"
"2019-07-29T00:00:00.000","Manhattan","John Jay","Early Bird","2","3","5","25","37","62"
"2019-07-29T00:00:00.000","Manhattan","Hamilton Fish","Early Bird","4","3","7","61","58","119"
"2019-07-26T00:00:00.000","Staten Island","Lyons","Early Bird","0","1","1","11","10","21"
"2019-07-26T00:00:00.000","Queens","Astoria","Early Bird","3","2","5","58","54","112"
"2019-07-26T00:00:00.000","Bronx","Crotona","Early Bird","0","0","0","1","3","4"
"2019-07-26T00:00:00.000","Bronx","Van Cortlandt","Early Bird","0","2","2","20","21","41"
"2019-07-26T00:00:00.000","Brooklyn","Sunset","Early Bird","0","0","0","0","0","0"
"2019-07-26T00:00:00.000","Brooklyn","Red Hook","Early Bird","1","7","8","23","44","67"
"2019-07-26T00:00:00.000","Brooklyn","McCarren","Early Bird","5","11","16","68","89","157"
"2019-07-26T00:00:00.000","Manhattan","Tony Dapolito","Early Bird","2","4","6","14","20","34"
"2019-07-26T00:00:00.000","Manhattan","Thomas Jefferson","Early Bird","0","1","1","9","14","23"
"2019-07-26T00:00:00.000","Manhattan","Jackie Robinson","Early Bird","0","1","1","9","14","23"
"2019-07-26T00:00:00.000","Manhattan","Asser Levy","Early Bird","1","2","3","16","35","51"
"2019-07-26T00:00:00.000","Manhattan","Lasker","Early Bird","7","7","14","40","52","92"
"2019-07-26T00:00:00.000","Manhattan","John Jay","Early Bird","1","4","5","43","63","106"
"2019-07-26T00:00:00.000","Manhattan","Hamilton Fish","Early Bird","4","1","5","60","60","120"
"2019-07-25T00:00:00.000","Staten Island","Lyons","Early Bird","0","0","0","9","10","19"
"2019-07-25T00:00:00.000","Queens","Astoria","Early Bird","4","6","10","55","44","99"
"2019-07-25T00:00:00.000","Bronx","Crotona","Early Bird","0","0","0","1","4","5"
"2019-07-25T00:00:00.000","Bronx","Van Cortlandt","Early Bird","1","1","2","16","17","33"
"2019-07-25T00:00:00.000","Brooklyn","Sunset","Early Bird","4","3","7","40","34","74"
"2019-07-25T00:00:00.000","Brooklyn","Red Hook","Early Bird","4","3","7","28","30","58"
"2019-07-25T00:00:00.000","Brooklyn","McCarren","Early Bird","2","3","5","76","62","138"
"2019-07-25T00:00:00.000","Manhattan","Tony Dapolito","Early Bird","1","1","2","15","18","33"
"2019-07-25T00:00:00.000","Manhattan","Thomas Jefferson","Early Bird","1","4","5","13","17","30"
"2019-07-25T00:00:00.000","Manhattan","Jackie Robinson","Early Bird","0","3","3","10","25","35"
"2019-07-25T00:00:00.000","Manhattan","Asser Levy","Early Bird","3","0","3","17","20","37"
"2019-07-25T00:00:00.000","Manhattan","Lasker","Early Bird","3","5","8","36","32","68"
"2019-07-25T00:00:00.000","Manhattan","John Jay","Early Bird","4","3","7","35","42","77"
"2019-07-25T00:00:00.000","Manhattan","Hamilton Fish","Early Bird","4","8","12","40","60","100"
"2019-07-24T00:00:00.000","Staten Island","Lyons","Early Bird","3","3","6","13","12","25"
"2019-07-24T00:00:00.000","Queens","Astoria","Early Bird","9","4","13","61","48","109"
"2019-07-24T00:00:00.000","Bronx","Crotona","Early Bird","0","2","2","1","5","6"
"2019-07-24T00:00:00.000","Bronx","Van Cortlandt","Early Bird","0","2","2","17","19","36"
"2019-07-24T00:00:00.000","Brooklyn","Sunset","Early Bird","2","2","4","36","44","80"
"2019-07-24T00:00:00.000","Brooklyn","Red Hook","Early Bird","2","5","7","22","28","50"
"2019-07-24T00:00:00.000","Brooklyn","McCarren","Early Bird","9","9","18","77","66","143"
"2019-07-24T00:00:00.000","Manhattan","Tony Dapolito","Early Bird","1","0","1","15","23","38"
"2019-07-24T00:00:00.000","Manhattan","Thomas Jefferson","Early Bird","0","2","2","11","12","23"
"2019-07-24T00:00:00.000","Manhattan","Jackie Robinson","Early Bird","0","2","2","8","34","42"
"2019-07-24T00:00:00.000","Manhattan","Asser Levy","Early Bird","1","1","2","18","29","47"
"2019-07-24T00:00:00.000","Manhattan","Lasker","Early Bird","2","5","7","31","32","63"
"2019-07-24T00:00:00.000","Manhattan","John Jay","Early Bird","5","4","9","40","50","90"
"2019-07-24T00:00:00.000","Manhattan","Hamilton Fish","Early Bird","2","3","5","58","67","125"
"2019-07-23T00:00:00.000","Staten Island","Lyons","Early Bird","0","0","0","4","3","7"
"2019-07-23T00:00:00.000","Queens","Astoria","Early Bird","0","0","0","19","12","31"
"2019-07-23T00:00:00.000","Bronx","Crotona","Early Bird","0","0","0","0","1","1"
"2019-07-23T00:00:00.000","Bronx","Van Cortlandt","Early Bird","0","0","0","4","4","8"
"2019-07-23T00:00:00.000","Brooklyn","Sunset","Early Bird","0","0","0","12","12","24"
"2019-07-23T00:00:00.000","Brooklyn","Red Hook","Early Bird","0","0","0","11","3","14"
"2019-07-23T00:00:00.000","Brooklyn","McCarren","Early Bird","0","1","1","21","18","39"
"2019-07-23T00:00:00.000","Manhattan","Tony Dapolito","Early Bird","0","0","0","6","13","19"
"2019-07-23T00:00:00.000","Manhattan","Thomas Jefferson","Early Bird","0","0","0","8","4","12"
"2019-07-23T00:00:00.000","Manhattan","Jackie Robinson","Early Bird","0","0","0","8","4","12"
"2019-07-23T00:00:00.000","Manhattan","Asser Levy","Early Bird","0","0","0","11","5","16"
"2019-07-23T00:00:00.000","Manhattan","Lasker","Early Bird","0","0","0","0","0","0"
"2019-07-23T00:00:00.000","Manhattan","John Jay","Early Bird","0","0","0","12","14","26"
"2019-07-23T00:00:00.000","Manhattan","Hamilton Fish","Early Bird","1","0","1","17","13","30"
"2019-07-22T00:00:00.000","Staten Island","Lyons","Early Bird","3","0","3","12","15","27"
"2019-07-22T00:00:00.000","Queens","Astoria","Early Bird","6","9","15","60","47","107"
"2019-07-22T00:00:00.000","Bronx","Crotona","Early Bird","0","0","0","2","2","4"
"2019-07-22T00:00:00.000","Bronx","Van Cortlandt","Early Bird","3","3","6","17","20","37"
"2019-07-22T00:00:00.000","Brooklyn","Sunset","Early Bird","3","3","6","37","46","83"
"2019-07-22T00:00:00.000","Brooklyn","Red Hook","Early Bird","5","2","7","25","20","45"
"2019-07-22T00:00:00.000","Brooklyn","McCarren","Early Bird","9","17","26","70","78","148"
"2019-07-22T00:00:00.000","Manhattan","Tony Dapolito","Early Bird","1","4","5","11","25","36"
"2019-07-22T00:00:00.000","Manhattan","Thomas Jefferson","Early Bird","2","3","5","11","16","27"
"2019-07-22T00:00:00.000","Manhattan","Jackie Robinson","Early Bird","1","0","1","14","27","41"
"2019-07-22T00:00:00.000","Manhattan","Asser Levy","Early Bird","3","3","6","23","32","55"
"2019-07-22T00:00:00.000","Manhattan","Lasker","Early Bird","6","14","20","44","56","100"
"2019-07-22T00:00:00.000","Manhattan","John Jay","Early Bird","5","6","11","37","46","83"
"2019-07-22T00:00:00.000","Manhattan","Hamilton Fish","Early Bird","3","3","6","65","67","132"
"2019-07-19T00:00:00.000","Staten Island","Lyons","Early Bird","2","2","4","13","13","26"
"2019-07-19T00:00:00.000","Queens","Astoria","Early Bird","2","5","7","33","38","71"
