"unique_line_id","fiscal_year","county_number","county_name","taxes_levied_on_property","uncollected_delinquent_taxes","credits_to_taxpayers","net_current_property_taxes","delinquent_property_taxes","penalties_and_interest","other_county_taxes","intergovernmental","licenses_and_permits","charges_for_services","use_of_money_and_property","miscellaneous","subtotal_revenue","operating_transfers_in","general_long_term_debt","fixed_asset_sales","total_revenues","beginning_fund_balances","total_resources","geocoded_column"
"2023_MUSCATINE_REVS_SA","2023","70","MUSCATINE","17259836","0","851700","16408136","2500","120000","2570458","13110403","113850","1095450","813525","372300","34606622","3350000","5738500","10700","43705822","28909773","72615595","POINT (-91.1127562 41.4839221)"
"2023_ADAIR_REVS_SA","2023","1","ADAIR","5900004","0","243775","5656229","0","31000","5052707","6550961","11350","241075","5048923","47300","22639545","5000000","1165855","0","28805400","15361474","44166874","POINT (-94.4709413 41.3307464)"
"2023_VAN BUREN_REVS_SA","2023","89","VAN BUREN","3008259","3300","176500","2828459","700","31000","410250","3918482","16150","247780","149010","296525","7898356","0","1106614","0","9004970","6849112","15854082","POINT (-91.9499871 40.7532294)"
"2023_BENTON_REVS_SA","2023","6","BENTON","14712582","0","965703","13746879","3937","98171","1467572","10797284","54400","849400","76143","582250","27676036","0","3634745","42800","31353581","17392623","48746204","POINT (-92.0656912 42.0801864)"
"2023_BUENA VISTA_REVS_SA","2023","11","BUENA VISTA","11071188","55355","528863","10486970","1095","22600","1282529","12434776","107655","1098925","150572","140500","25725622","0","3270723","0","28996345","11103663","40100008","POINT (-95.15114900000002 42.7354936)"
"2023_LINN_REVS_SA","2023","57","LINN","75515234","233635","3203610","72077989","61560","590710","9412944","53674590","1299852","8826488","669000","1443908","148057041","6000000","25694448","59500","179810989","65021047","244832036","POINT (-91.5989646 42.0789478)"
"2023_HARRISON_REVS_SA","2023","43","HARRISON","10037783","2400","417507","9617876","1350","50750","840206","7103103","36000","870351","179079","2087965","20786680","0","2576000","0","23362680","11925203","35287883","POINT (-95.8169209 41.6828528)"
"2023_DALLAS_REVS_SA","2023","25","DALLAS","25302362","0","538000","24764362","0","103500","5678186","7628948","239850","3346587","437576","1233050","43432059","0","11556125","0","54988184","30760736","85748920","POINT (-94.0397374 41.6848862)"
"2023_GRUNDY_REVS_SA","2023","38","GRUNDY","7406152","0","261300","7144852","0","3000","781446","11009894","8150","375150","80500","224399","19627391","0","4512315","0","24139706","8381233","32520939","POINT (-92.7914177 42.4018651)"
"2023_DAVIS_REVS_SA","2023","26","DAVIS","5068096","0","283548","4784548","0","63648","1050848","6646275","1000","294800","162712","864786","13868617","0","1175655","0","15044272","6217733","21262005","POINT (-92.4097173 40.7476891)"
"2023_JONES_REVS_SA","2023","53","JONES","9431025","850","538759","8891416","0","29350","1356689","8785161","71836","737621","232732","539370","20644175","0","2869490","90000","23603665","11332670","34936335","POINT (-91.1314352 42.1212397)"
"2023_CASS_REVS_SA","2023","15","CASS","8144940","0","458615","7686325","1000","32300","2196842","4800481","21090","387790","106884","1578460","16811172","0","5091395","0","21902567","15247565","37150132","POINT (-94.9278266 41.3314876)"
"2023_CLAY_REVS_SA","2023","21","CLAY","8570064","0","544955","8025109","295","20750","1795825","5588286","17480","654915","374499","583160","17060319","500000","3689899","0","21250218","23557397","44807615","POINT (-95.1509194 43.0825804)"
"2023_IDA_REVS_SA","2023","47","IDA","3421841","0","102500","3319341","75","7000","2505890","3309903","11200","272400","17650","265818","9709277","0","2998142","0","12707419","20740992","33448411","POINT (-95.5134962 42.3868747)"
"2023_WEBSTER_REVS_SA","2023","94","WEBSTER","16265541","0","761062","15504479","1256","12080","5159055","18993933","91140","1736490","305314","864005","42667752","0","7047492","150000","49865244","25229932","75095176","POINT (-94.18178810000002 42.4279662)"
"2023_LOUISA_REVS_SA","2023","58","LOUISA","5985511","3211","318584","5663716","0","0","1169827","3619130","38550","560870","45819","268480","11366392","0","1667096","0","13033488","3652124","16685612","POINT (-91.2596184 41.2185073)"
"2023_POWESHIEK_REVS_SA","2023","79","POWESHIEK","8343226","0","299400","8043826","0","0","1753691","5179921","24250","625695","51679","148800","15827862","0","4216469","0","20044331","16555110","36599441","POINT (-92.53146840000001 41.6864422)"
"2023_DICKINSON_REVS_SA","2023","30","DICKINSON","11708043","1300","322400","11384343","1300","35000","2441892","8799005","70500","903430","128319","360950","24124739","0","5300415","500","29425654","17454295","46879949","POINT (-95.1508301 43.3779848)"
"2023_STORY_REVS_SA","2023","85","STORY","28147360","0","956695","27190665","3450","75000","3926900","18977985","73160","2002995","432156","574700","53257011","0","3785000","14500","57056511","28736368","85792879","POINT (-93.4650448 42.0362415)"
"2023_MAHASKA_REVS_SA","2023","62","MAHASKA","9768290","0","150666","9617624","0","42600","2228775","7233413","16500","692645","100833","419328","20351718","0","2586598","0","22938316","18683970","41622286","POINT (-92.6409094 41.3352035)"
"2023_WAPELLO_REVS_SA","2023","90","WAPELLO","9833456","0","649666","9183790","4962","0","2596091","5533004","68600","715785","223213","1858616","20184061","0","1322000","2100","21508161","17008490","38516651","POINT (-92.4094499 41.03058450000001)"
"2023_ADAMS_REVS_SA","2023","2","ADAMS","4789926","0","221142","4568784","0","0","498716","3486558","4100","700730","55150","44110","9358148","0","1440767","0","10798915","4861156","15660071","POINT (-94.6991849 41.02898390000001)"
"2023_PLYMOUTH_REVS_SA","2023","75","PLYMOUTH","11380775","1000","485567","10894208","1000","54000","2252035","12473906","44200","1272950","171940","352100","27516339","0","4785000","0","32301339","16121198","48422537","POINT (-96.2140431 42.7378346)"
"2023_WORTH_REVS_SA","2023","98","WORTH","5690338","38468","339930","5311940","39522","40882","4253417","4680871","218968","321201","118238","40000","15025039","0","1373294","17002","16415335","4206658","20621993","POINT (-93.2608476 43.3773984)"
"2023_BLACK HAWK_REVS_SA","2023","7","BLACK HAWK","35644624","0","1851999","33792625","5550","270000","4755798","17963407","626200","4041169","486675","1150412","63091836","0","13232892","6053","76330781","51583656","127914437","POINT (-92.3088197 42.4700957)"
"2023_MADISON_REVS_SA","2023","61","MADISON","7488108","0","367758","7120350","33","67255","1197712","5583361","82421","1191350","95535","148153","15486170","0","2339785","2000","17827955","10939029","28766984","POINT (-94.01556190000001 41.33071420000001)"
"2023_TAMA_REVS_SA","2023","86","TAMA","10168219","0","0","10168219","982","24438","1658288","10266143","30350","542643","160805","559041","23410909","0","3951336","30750","27392995","14756669","42149664","POINT (-92.5325425 42.07981170000001)"
"2023_DES MOINES_REVS_SA","2023","29","DES MOINES","14230224","5220","820731","13404273","5220","87250","2732480","5844686","49235","926860","212975","321174","23584153","3968662","3012643","15000","30580458","18637865","49218323","POINT (-91.1814707 40.9231829)"
"2023_GUTHRIE_REVS_SA","2023","39","GUTHRIE","8774015","0","253900","8520115","650","43000","2220525","5571510","1095706","867720","54302","644050","19017578","50500","2925767","0","21993845","10963423","32957268","POINT (-94.501055 41.6837548)"
"2023_O'BRIEN_REVS_SA","2023","71","O'BRIEN","7633483","0","308070","7325413","300","18510","862776","5699127","114500","604700","197690","134500","14957516","0","4955127","0","19912643","11255831","31168474","POINT (-95.6248784 43.0837527)"
"2023_CLAYTON_REVS_SA","2023","22","CLAYTON","9268257","0","0","9268257","400","20900","1182149","6905142","39600","475255","144560","720194","18756457","0","2000000","10000","20766457","13052140","33818597","POINT (-91.34143280000002 42.8447493)"
"2023_FLOYD_REVS_SA","2023","34","FLOYD","8814514","0","371465","8443049","0","19020","1571215","5318309","29300","590730","108900","235850","16316373","0","1600855","0","17917228","10394535","28311763","POINT (-92.78900330000002 43.0599208)"
"2023_WAYNE_REVS_SA","2023","93","WAYNE","4249421","71845","167642","4009934","0","0","576059","4604509","9750","363656","18025","3487","9585420","0","869823","0","10455243","6962317","17417560","POINT (-93.3273639 40.73947020000001)"
"2023_MITCHELL_REVS_SA","2023","66","MITCHELL","6730242","0","262295","6467947","0","10000","5160433","4758395","6000","685850","276143","85700","17450468","0","1979942","1000","19431410","6076838","25508248","POINT (-92.7890315 43.3564124)"
"2023_BUCHANAN_REVS_SA","2023","10","BUCHANAN","9647480","2750","440000","9204730","6270","41500","1485643","7133347","37430","695936","202081","125750","18932687","0","2725898","0","21658585","9588425","31247010","POINT (-91.8378392 42.4707777)"
"2023_KEOKUK_REVS_SA","2023","54","KEOKUK","6046635","20000","331800","5694835","1450","41000","733265","5357912","52000","518305","376339","125570","12900676","500","2245200","0","15146376","7176485","22322861","POINT (-92.1786426 41.336465)"
"2023_POTTAWATTAMIE_REVS_SA","2023","78","POTTAWATTAMIE","47266412","0","1647000","45619412","3000","147000","8682380","24326996","307300","3030375","246255","2368250","84730968","1745000","10852596","0","97328564","78279482","175608046","POINT (-95.5423935 41.3366123)"
"2023_WOODBURY_REVS_SA","2023","97","WOODBURY","37831351","0","1504648","36326703","18500","283000","7693350","9950547","34650","2475231","271050","647311","57700342","2676430","11273666","0","71650438","34610916","106261354","POINT (-96.0447673 42.3897169)"
"2023_CARROLL_REVS_SA","2023","14","CARROLL","9689311","0","622890","9066421","0","0","1688629","8900240","47200","2546153","168449","532880","22949972","0","3378471","0","26328443","9457803","35786246","POINT (-94.8605593 42.0362382)"
"2023_HARDIN_REVS_SA","2023","42","HARDIN","9390092","0","323900","9066192","0","3000","983638","7554476","36950","519760","176685","52925","18393626","0","2444425","0","20838051","11464408","32302459","POINT (-93.2404025 42.3838803)"
"2023_PALO ALTO_REVS_SA","2023","74","PALO ALTO","7225727","3100","316435","6906192","0","10000","2019104","4552504","19200","674362","169627","241137","14592126","0","2849734","0","17441860","20473315","37915175","POINT (-94.6781371 43.0820643)"
"2023_ALLAMAKEE_REVS_SA","2023","3","ALLAMAKEE","7799714","0","397885","7401829","0","0","1208684","5277156","25839","337810","122577","487333","14861228","3500","2104746","0","16969474","7358756","24328230","POINT (-91.3780923 43.2842838)"
"2023_FAYETTE_REVS_SA","2023","33","FAYETTE","10109414","2550","586024","9520840","2025","36967","1008235","9496099","38625","934911","138986","944605","22121293","0","2692243","0","24813536","13468841","38282377","POINT (-91.8443207 42.8625919)"
"2023_FRANKLIN_REVS_SA","2023","35","FRANKLIN","9985282","750","371173","9613359","0","0","1000934","9909373","22150","466312","145715","142285","21300128","0","3168473","0","24468601","10605615","35074216","POINT (-93.262473 42.7325458)"
"2023_HUMBOLDT_REVS_SA","2023","46","HUMBOLDT","6821402","0","329933","6491469","615","15575","817691","4653376","5000","366430","53340","658160","13061656","0","2065557","1000","15128213","8046489","23174702","POINT (-94.2071868 42.7764686)"
"2023_MILLS_REVS_SA","2023","65","MILLS","10433393","0","256386","10177007","0","26734","1989025","6890524","212400","476070","205125","265865","20242750","0","3209722","0","23452472","10724635","34177107","POINT (-95.62132670000001 41.0334523)"
"2023_CHEROKEE_REVS_SA","2023","18","CHEROKEE","5989991","0","320441","5669550","0","10000","1067669","4630411","60500","422345","109552","238274","12208301","0","2050000","5100","14263401","12071969","26335370","POINT (-95.6238055 42.7356226)"
"2023_CLINTON_REVS_SA","2023","23","CLINTON","21908594","0","0","21908594","5100","136400","2909930","16255971","41550","1155370","312331","257000","42982246","0","2144700","0","45126946","21347731","66474677","POINT (-90.5319724 41.8980358)"
"2023_HOWARD_REVS_SA","2023","45","HOWARD","6239649","0","328846","5910803","250","11848","1927422","5914555","21000","498177","128780","108941","14521776","0","2401019","0","16922795","8347509","25270304","POINT (-92.3171989 43.3567673)"
"2023_LYON_REVS_SA","2023","60","LYON","6967648","0","327600","6640048","0","25740","2198344","6841572","68900","1075445","123366","150050","17123465","0","7554417","0","24677882","8595665","33273547","POINT (-96.2102924 43.380497)"
"2023_DELAWARE_REVS_SA","2023","28","DELAWARE","11587323","3500","572859","11010964","325","30200","1503593","6158483","44250","590750","265631","146435","19750631","0","3135933","0","22886564","17401604","40288168","POINT (-91.3673502 42.471211)"
"2023_OSCEOLA_REVS_SA","2023","72","OSCEOLA","4711424","0","246142","4465282","1650","6000","658760","3487884","32800","345480","99744","38090","9135690","0","1640528","0","10776218","6704668","17480886","POINT (-95.6236852 43.3785704)"
"2023_CALHOUN_REVS_SA","2023","13","CALHOUN","8402722","58700","273100","8070922","500","21120","473832","5550280","10050","1093175","89655","112825","15422359","0","2304419","100","17726878","10393887","28120765","POINT (-94.6404136 42.385184800000005)"
"2023_KOSSUTH_REVS_SA","2023","55","KOSSUTH","9443995","0","482850","8961145","0","22000","1826178","7764128","26150","664850","172452","70020","19506923","33250","2988591","15000","22543764","13944363","36488127","POINT (-94.2067199 43.20413)"
"2023_JASPER_REVS_SA","2023","50","JASPER","16488803","75000","255000","16158803","100","40000","1724680","11104902","160000","1431777","175227","807194","31602683","0","5016231","1500000","38118914","24176559","62295473","POINT (-93.053765 41.6860394)"
"2023_TAYLOR_REVS_SA","2023","87","TAYLOR","4140982","3030","252104","3885848","1600","0","289946","5740498","5600","301220","45260","140360","10410332","0","961395","0","11371727","3986458","15358185","POINT (-94.6964148 40.73743240000001)"
"2023_SCOTT_REVS_SA","2023","82","SCOTT","61347324","18716","2387138","58941470","18716","590000","8708035","31829566","758595","7120085","334455","1056723","109357645","0","27938070","167000","137462715","35493364","172956079","POINT (-90.6232428 41.6370978)"
"2023_POLK_REVS_SA","2023","77","POLK","205511613","842981","7669289","196999343","21500","1315000","8078467","66106945","1241050","17937232","7351872","6606465","305657874","0","120900513","84000","426642387","222686872","649329259","POINT (-93.5735335 41.6855048)"
"2023_BOONE_REVS_SA","2023","8","BOONE","8142020","2300","352936","7786784","3350","67500","1852678","6094890","34350","1141750","161390","1517550","18660242","0","4667512","48000","23375754","9852643","33228397","POINT (-93.931671 42.0365493)"
"2023_HAMILTON_REVS_SA","2023","40","HAMILTON","10521678","0","512652","10009026","0","20730","1078413","7765156","57175","2464908","333598","1863512","23592518","0","3710093","25100","27327711","4978344","32306055","POINT (-93.7068085 42.3837722)"
"2023_WRIGHT_REVS_SA","2023","99","WRIGHT","9360342","0","471038","8889304","0","19050","3618534","5593820","18100","572990","257572","147039","19116409","0","2502097","4000","21622506","8300312","29922818","POINT (-93.7351465 42.7331189)"
"2023_WASHINGTON_REVS_SA","2023","92","WASHINGTON","12904026","0","725236","12178790","1008","53500","2381257","7788418","79750","2179705","194183","1756120","26612731","5155","2927735","250","29545871","13390219","42936090","POINT (-91.7178676 41.335591)"
"2023_MONONA_REVS_SA","2023","67","MONONA","7520756","0","0","7520756","870","10910","524787","8259303","8650","331600","77580","73156","16807612","0","1632155","50000","18489767","6574196","25063963","POINT (-95.9599235 42.0516663)"
"2023_APPANOOSE_REVS_SA","2023","4","APPANOOSE","4559100","0","321148","4237952","0","12000","1274196","4068215","4150","341500","30015","40190","10008218","102530","972759","0","11083507","13390141","24473648","POINT (-92.8686104 40.7431635)"
"2023_SAC_REVS_SA","2023","81","SAC","7989854","5800","444220","7539834","330","11375","729970","8688968","16500","1391948","63067","97100","18539092","0","1991528","11500","20542120","8114617","28656737","POINT (-95.1053946 42.3862604)"
"2023_FREMONT_REVS_SA","2023","36","FREMONT","5906108","200","296440","5609468","1090","24045","748307","11545588","19900","341705","107327","165255","18562685","92248","1419730","70000","20144663","6029901","26174564","POINT (-95.6046765 40.7455892)"
"2023_JACKSON_REVS_SA","2023","49","JACKSON","7992280","0","479565","7512715","145","3075","1345159","7806576","47285","645225","360293","224091","17944564","0","1435169","5025","19384758","15143708","34528466","POINT (-90.5742294 42.1717426)"
"2023_MARSHALL_REVS_SA","2023","64","MARSHALL","14686061","0","820788","13865273","1000","80000","2530357","8863312","54325","911551","233725","2655667","29195210","0","7179000","10600","36384810","21013943","57398753","POINT (-92.9987706 42.0358499)"
"2023_CHICKASAW_REVS_SA","2023","19","CHICKASAW","6694445","21203","325850","6347392","500","10200","915093","5333121","23233","871971","66927","201800","13770237","0","2326061","0","16096298","8944876","25041174","POINT (-92.3176637 43.06004140000001)"
"2023_WINNESHIEK_REVS_SA","2023","96","WINNESHIEK","10761219","180","584749","10176290","180","45350","1606171","10503634","44850","795820","179405","2241128","25592828","0","2846379","15000","28454207","10819376","39273583","POINT (-91.8437074 43.2906746)"
"2023_JEFFERSON_REVS_SA","2023","51","JEFFERSON","7410411","5400","406000","6999011","1080","56400","948608","7485157","24900","1857200","56000","65462","17493818","0","1200000","0","18693818","8068687","26762505","POINT (-91.9488774 41.0317596)"
"2023_MONROE_REVS_SA","2023","68","MONROE","5612726","0","244419","5368307","0","0","615125","4417614","3000","148000","37665","54500","10644211","0","1738657","5000","12387868","7980191","20368059","POINT (-92.8689877 41.0297826)"
"2023_CERRO GORDO_REVS_SA","2023","17","CERRO GORDO","18819106","0","919550","17899556","25000","244000","2930150","11037220","20050","1273400","282380","1038529","34750285","0","10832215","35000","45617500","27074144","72691644","POINT (-93.2608184 43.081557700000005)"
"2023_EMMET_REVS_SA","2023","32","EMMET","5226818","1500","289560","4935758","1500","16070","401517","4275872","22500","357453","39890","270079","10320639","0","1183687","0","11504326","8927264","20431590","POINT (-94.6784803 43.37802250000001)"
"2023_BUTLER_REVS_SA","2023","12","BUTLER","7642593","0","0","7642593","650","20700","2419051","7052926","63100","572939","232636","404440","18409035","0","5335000","0","23744035","14659587","38403622","POINT (-92.7901934 42.7315661)"
"2023_PAGE_REVS_SA","2023","73","PAGE","6443807","0","377600","6066207","1450","31040","799014","4338731","20400","310535","81255","220921","11869553","0","1476088","20000","13365641","9877981","23243622","POINT (-95.1501747 40.7391444)"
"2023_HENRY_REVS_SA","2023","44","HENRY","9956775","0","564345","9392430","1557","53300","1321974","6567059","32050","688800","56280","139300","18252750","625000","1882958","0","20760708","7725063","28485771","POINT (-91.5445241 40.9879383)"
"2023_UNION_REVS_SA","2023","88","UNION","5926696","0","249250","5677446","5650","24350","1104834","3860789","27581","472305","41504","665800","11880259","0","1057264","0","12937523","6134710","19072233","POINT (-94.2423792 41.0277304)"
"2023_HANCOCK_REVS_SA","2023","41","HANCOCK","6086286","0","277000","5809286","615","13000","800983","5524717","24600","421995","293488","183770","13072454","0","2646664","0","15719118","11700050","27419168","POINT (-93.7342723 43.0818861)"
"2023_DECATUR_REVS_SA","2023","27","DECATUR","3836572","0","236300","3600272","0","0","362125","3912025","400","284315","16000","119900","8295037","0","687323","0","8982360","4187677","13170037","POINT (-93.7862815 40.7376827)"
"2023_LEE_REVS_SA","2023","56","LEE","13859547","0","801940","13057607","9550","56010","3419965","11558447","324850","1249730","301772","2336718","32314649","0","2733332","0","35047981","17725705","52773686","POINT (-91.479264 40.6419764)"
"2023_CRAWFORD_REVS_SA","2023","24","CRAWFORD","9944473","9400","415650","9519423","10800","33150","884971","7645511","10750","1156070","254680","185772","19701127","100000","4022500","415250","24238877","11582213","35821090","POINT (-95.3819678 42.0372125)"
"2023_BREMER_REVS_SA","2023","9","BREMER","8693879","0","434173","8259706","365","25500","1526029","6949889","307918","898900","267116","424732","18660155","0","3407949","40000","22108104","18737570","40845674","POINT (-92.31805480000001 42.7745873)"
"2023_POCAHONTAS_REVS_SA","2023","76","POCAHONTAS","6964070","75","278000","6685995","75","11025","358660","5370546","35000","588629","113380","72360","13235670","0","1736605","1000","14973275","15769892","30743167","POINT (-94.67874660000001 42.73413510000001)"
"2023_LUCAS_REVS_SA","2023","59","LUCAS","3626616","0","97000","3529616","11800","26000","646201","4371502","1850","259310","67000","172800","9086079","0","803797","500","9890376","3511697","13402073","POINT (-93.3277207 41.0293738)"
"2023_SHELBY_REVS_SA","2023","83","SHELBY","7486014","0","300000","7186014","100","25000","792585","4420155","24300","318672","236516","408110","13411452","0","4539901","0","17951353","5589437","23540790","POINT (-95.31021130000002 41.6850926)"
"2023_GREENE_REVS_SA","2023","37","GREENE","6767057","0","313325","6453732","0","10000","1801306","4993141","94375","827701","61327","603810","14845392","0","2025342","0","16870734","5643984","22514718","POINT (-94.3968356 42.0362394)"
"2023_DUBUQUE_REVS_SA","2023","31","DUBUQUE","33979117","3660","1589000","32386457","3660","116000","5875779","11686169","126380","2678858","461483","1683586","55018372","0","5420163","0","60438535","54396890","114835425","POINT (-90.8824564 42.468832)"
"2023_JOHNSON_REVS_SA","2023","52","JOHNSON","64656960","0","1907098","62749862","0","344000","1067012","23976946","827550","5165580","1075883","1525930","96732763","20439000","18462818","32000","135666581","64466047","200132628","POINT (-91.5880849 41.6715511)"
"2023_CLARKE_REVS_SA","2023","20","CLARKE","4803162","812","209556","4592794","785","45000","319372","4883318","34100","322220","32017","277500","10507106","0","938190","0","11445296","4652050","16097346","POINT (-93.78515790000002 41.0290323)"
"2023_AUDUBON_REVS_SA","2023","5","AUDUBON","5460734","0","0","5460734","0","0","1010152","3967579","14500","289210","23161","33550","10798886","400000","4612268","20000","15831154","10375660","26206814","POINT (-94.9058222 41.6845893)"
"2023_RINGGOLD_REVS_SA","2023","80","RINGGOLD","3647879","0","152000","3495879","450","15500","413639","4964523","8000","236840","40540","322429","9497800","0","950000","500","10448300","4954622","15402922","POINT (-94.2439719 40.7352023)"
"2023_WINNEBAGO_REVS_SA","2023","95","WINNEBAGO","7066472","0","0","7066472","535","8020","2798169","3750089","18100","1206435","301407","1464854","16614081","0","2400915","0","19014996","13609274","32624270","POINT (-93.7341955 43.37756780000001)"
"2023_IOWA_REVS_SA","2023","48","IOWA","9347606","0","517524","8830082","0","20800","2157767","7087867","36650","2332368","436565","144616","21046715","0","1315000","0","22361715","13490900","35852615","POINT (-92.065524 41.6863229)"
"2023_CEDAR_REVS_SA","2023","16","CEDAR","9673543","0","506411","9167132","400","22200","1245054","6603017","41189","1258596","153712","146403","18637703","0","2849513","58000","21545216","18422993","39968209","POINT (-91.1324125 41.7723207)"
"2023_MONTGOMERY_REVS_SA","2023","69","MONTGOMERY","6629357","0","365280","6264077","0","24700","646136","4939234","13850","325915","67371","74941","12356224","0","1095000","0","13451224","5622696","19073920","POINT (-95.1563758 41.03014)"
"2023_MARION_REVS_SA","2023","63","MARION","14379278","0","759689","13619589","500","53000","1856478","10753128","51150","1635775","75960","204670","28250250","0","3009412","75000","31334662","20878225","52212887","POINT (-93.0994367 41.3344515)"
"2023_WARREN_REVS_SA","2023","91","WARREN","17980949","0","690500","17290449","1160","113176","2867871","13082575","123575","1745290","219050","559192","36002338","0","3385000","5000","39392338","21511678","60904016","POINT (-93.5613594 41.3343735)"
"2023_SIOUX_REVS_SA","2023","84","SIOUX","9521227","0","496190","9025037","550","59800","2360743","8602330","19500","1019985","227399","1368679","22684023","0","5073086","4250","27761359","30885238","58646597","POINT (-96.1778827 43.0826174)"
"2016_JOHNSON_REVS_SA","2016","52","JOHNSON","51265773","0","1296089","49969684","700","329000","874183","19634603","646225","4161787","219234","2629378","78464794","20826561","13930000","210650","113432005","21705515","135137520","POINT (-91.5880849 41.6715511)"
"2019_ADAMS_REVS_SA","2019","2","ADAMS","3650760","0","162822","3487938","0","0","551379","3031967","4638","462345","30275","57570","7626112","1036711","0","0","8662823","3175666","11838489","POINT (-94.6991849 41.02898390000001)"
"2010_MUSCATINE_REVS_SA","2010","70","MUSCATINE","13287293","0","413400","12873893","13500","135500","4970814","9741598","70350","861450","474500","103050","29244655","1352950","0","7000","30604605","5374000","35978605","POINT (-91.1127562 41.4839221)"
"2020_IDA_REVS_SA","2020","47","IDA","2812951","0","142500","2670451","100","15000","1276856","3454130","28150","242825","69060","212225","7968797","1487713","0","0","9456510","20012045","29468555","POINT (-95.5134962 42.3868747)"
"2018_CHEROKEE_REVS_SA","2018","18","CHEROKEE","5887897","0","316200","5571697","0","24350","1044709","4603536","62600","326682","63426","178500","11875500","2000000","0","1000","13876500","9245031","23121531","POINT (-95.6238055 42.7356226)"
"2016_FREMONT_REVS_SA","2016","36","FREMONT","4787633","0","309904","4477729","1400","24045","994383","3645623","26700","283375","76597","68720","9598572","1233191","604648","24000","11460411","8815934","20276345","POINT (-95.6046765 40.7455892)"
"2020_FRANKLIN_REVS_SA","2020","35","FRANKLIN","7189046","1000","362838","6825208","1000","0","3563750","4972391","30250","389066","121180","119475","16022320","3215805","0","55000","19293125","7822787","27115912","POINT (-93.262473 42.7325458)"
"2013_MONTGOMERY_REVS_SA","2013","69","MONTGOMERY","5118669","2100","217818","4898751","1010","15800","586490","3511583","8600","251340","70180","43500","9387254","1115251","0","0","10502505","6079012","16581517","POINT (-95.1563758 41.03014)"
"2011_HAMILTON_REVS_SA","2011","40","HAMILTON","6739481","5000","255336","6479145","3900","30400","1055729","6210679","12475","1047421","98869","1795268","16733886","2398486","0","0","19132372","4358959","23491331","POINT (-93.7068085 42.3837722)"
"2022_ALLAMAKEE_REVS_SA","2022","3","ALLAMAKEE","7927382","0","429282","7498100","0","0","987492","5314932","20314","343835","121737","335909","14622319","2111630","3500","0","16737449","5313725","22051174","POINT (-91.3780923 43.2842838)"
"2021_RINGGOLD_REVS_SA","2021","80","RINGGOLD","3595941","0","161550","3434391","505","25100","338077","4696573","500","535327","62340","634700","9727513","850000","0","0","10577513","4533083","15110596","POINT (-94.2439719 40.7352023)"
"2017_MONROE_REVS_SA","2017","68","MONROE","4851970","0","255342","4596628","445","5500","544428","4646834","2000","160250","47403","23445","10026933","2099640","0","5000","12131573","4098469","16230042","POINT (-92.8689877 41.0297826)"
"2011_ALLAMAKEE_REVS_SA","2011","3","ALLAMAKEE","4957289","0","234452","4722837","325","0","733152","4312889","19075","219000","136461","19500","10163239","1400961","0","5500","11569700","4533401","16103101","POINT (-91.3780923 43.2842838)"
"2014_SIOUX_REVS_SA","2014","84","SIOUX","8391625","0","295640","8095985","700","31000","1918301","6773315","9000","772845","105374","591576","18298096","2895920","0","5000","21199016","9418177","30617193","POINT (-96.1778827 43.0826174)"
"2021_CERRO GORDO_REVS_SA","2021","17","CERRO GORDO","19276786","0","934222","18342564","27500","203500","2833666","10108460","132150","1367670","711118","1107823","34834451","8594587","0","380000","43809038","18334912","62143950","POINT (-93.2608184 43.081557700000005)"
"2013_JEFFERSON_REVS_SA","2013","51","JEFFERSON","5571871","6000","170000","5395871","580","79000","751517","3580590","14689","493378","144430","124015","10584070","1000000","950000","0","12534070","2916635","15450705","POINT (-91.9488774 41.0317596)"
"2022_JASPER_REVS_SA","2022","50","JASPER","16500240","70000","250000","16180240","100","40000","1269225","9591893","205100","1302642","221117","4142401","32952718","6073545","0","0","39026263","18206169","57232432","POINT (-93.053765 41.6860394)"
"2018_KOSSUTH_REVS_SA","2018","55","KOSSUTH","8856655","0","480701","8375954","0","36025","1512210","7351620","14850","609000","157305","72950","18129914","2863123","20957","50000","21063994","9163915","30227909","POINT (-94.2067199 43.20413)"
"2019_CHICKASAW_REVS_SA","2019","19","CHICKASAW","6054980","1217","321525","5732238","112","25000","862558","4615883","7550","625364","79815","170400","12118920","2176300","0","0","14295220","6401146","20696366","POINT (-92.3176637 43.06004140000001)"
"2013_GREENE_REVS_SA","2013","37","GREENE","5119026","0","200500","4918526","0","5000","542900","3660049","55225","346625","28036","263700","9820061","1255000","0","0","11075061","3272802","14347863","POINT (-94.3968356 42.0362394)"
"2016_FRANKLIN_REVS_SA","2016","35","FRANKLIN","6516570","1250","305923","6209397","1250","21025","2366946","5728107","16750","617150","124836","98994","15184455","2000682","0","12000","17197137","6132942","23330079","POINT (-93.262473 42.7325458)"
"2020_HARDIN_REVS_SA","2020","42","HARDIN","8670671","0","454500","8216171","2150","0","1140845","6862467","31200","443450","232030","1504628","18432941","3089465","0","0","21522406","9885886","31408292","POINT (-93.2404025 42.3838803)"
"2012_JOHNSON_REVS_SA","2012","52","JOHNSON","42799570","0","507626","42291944","300","429000","916861","20135803","478600","3644275","355125","2291222","70543130","22161443","0","11800","92716373","20376447","113092820","POINT (-91.5880849 41.6715511)"
"2019_ALLAMAKEE_REVS_SA","2019","3","ALLAMAKEE","7575337","0","479851","7095486","0","0","1006618","5210116","20839","321780","77455","146134","13878428","2010000","10000","5800","15904228","3866811","19771039","POINT (-91.3780923 43.2842838)"
"2015_CRAWFORD_REVS_SA","2015","24","CRAWFORD","8062807","13957","364050","7684800","1090","55000","794525","5952866","4500","806050","115820","182562","15597213","2965000","0","39000","18601213","7166338","25767551","POINT (-95.3819678 42.0372125)"
"2020_WEBSTER_REVS_SA","2020","94","WEBSTER","13952786","2713","801143","13148930","0","9248","4137208","13166908","79500","1107250","382424","348741","32380209","5893522","0","0","38273731","17606336","55880067","POINT (-94.18178810000002 42.4279662)"
"2019_OSCEOLA_REVS_SA","2019","72","OSCEOLA","4451822","0","263236","4188586","576","10000","855211","3196904","32000","320985","90247","49120","8743629","1646891","0","0","10390520","8383706","18774226","POINT (-95.6236852 43.3785704)"
"2014_PAGE_REVS_SA","2014","73","PAGE","4573998","2700","191906","4379392","2200","31200","610338","4121901","45440","345234","79235","454042","10068982","1180242","0","0","11249224","4527498","15776722","POINT (-95.1501747 40.7391444)"
"2012_GREENE_REVS_SA","2012","37","GREENE","4676405","0","201600","4474805","0","5000","505775","3719672","9225","346625","28073","312100","9401275","1201000","0","0","10602275","3274886","13877161","POINT (-94.3968356 42.0362394)"
"2019_JEFFERSON_REVS_SA","2019","51","JEFFERSON","6726269","4600","375000","6346669","1230","56500","771023","3894987","30000","721815","48001","50990","11921215","1000000","0","0","12921215","4699092","17620307","POINT (-91.9488774 41.0317596)"
"2010_ADAIR_REVS_SA","2010","1","ADAIR","3045099","1637","174546","2868916","1150","27000","630778","4053066","9450","173129","124748","19811","7908048","1589688","0","1000","9498736","2938703","12437439","POINT (-94.4709413 41.3307464)"
"2021_WARREN_REVS_SA","2021","91","WARREN","18566858","0","736900","17829958","1430","113500","2218786","7851440","106625","1445270","643845","257994","30468848","3725000","800000","0","34993848","35775396","70769244","POINT (-93.5613594 41.3343735)"
"2017_STORY_REVS_SA","2017","85","STORY","23613131","0","1027338","22585793","1000","50000","3404906","8487656","62680","1829130","739759","595120","37756044","2945822","74600","2000","40778466","14200683","54979149","POINT (-93.4650448 42.0362415)"
"2015_MADISON_REVS_SA","2015","61","MADISON","4999621","0","246695","4752926","0","67255","944072","4928432","50325","1100545","92048","291765","12227368","1558463","0","1500","13787331","3565095","17352426","POINT (-94.01556190000001 41.33071420000001)"
"2016_PAGE_REVS_SA","2016","73","PAGE","5637707","2250","237400","5398057","2200","31200","616650","4194703","24715","356840","91546","344996","11060907","1230582","600000","5000","12896489","5230410","18126899","POINT (-95.1501747 40.7391444)"
"2010_VAN BUREN_REVS_SA","2010","89","VAN BUREN","2324133","850","152600","2170683","850","30510","366661","3327568","17650","236480","151880","85510","6387792","536785","0","10100","6934677","2097507","9032184","POINT (-91.9499871 40.7532294)"
"2021_CLAYTON_REVS_SA","2021","22","CLAYTON","8876189","0","0","8876189","450","28600","1458962","5757889","37650","468085","144420","171110","16943355","2200000","0","10000","19153355","5888356","25041711","POINT (-91.34143280000002 42.8447493)"
"2014_TAMA_REVS_SA","2014","86","TAMA","8070162","0","383788","7686374","1950","22000","702628","5327639","8550","582777","97850","1619043","16048811","2027364","0","0","18076175","15893628","33969803","POINT (-92.5325425 42.07981170000001)"
"2013_LEE_REVS_SA","2013","56","LEE","10114193","0","414003","9700190","11014","111606","2268906","10050901","120250","1005795","265370","370720","23904752","1425000","0","0","25329752","7877854","33207606","POINT (-91.479264 40.6419764)"
"2022_CALHOUN_REVS_SA","2022","13","CALHOUN","8021888","62340","319550","7639998","500","26620","485433","5129841","10100","1023053","113685","98175","14527405","1841936","0","100","16369441","10566182","26935623","POINT (-94.6404136 42.385184800000005)"
"2014_CALHOUN_REVS_SA","2014","13","CALHOUN","6287685","0","235500","6052185","0","0","522991","4257481","13550","819740","109640","60450","11836037","1324434","0","500","13160971","10310410","23471381","POINT (-94.6404136 42.385184800000005)"
"2019_TAYLOR_REVS_SA","2019","87","TAYLOR","4447691","3230","258692","4185769","715","0","307094","5467413","5266","270900","40700","74068","10351925","813427","0","0","11165352","3151772","14317124","POINT (-94.6964148 40.73743240000001)"
"2011_OSCEOLA_REVS_SA","2011","72","OSCEOLA","2916376","1565","173631","2741180","1600","0","585240","2813422","15100","248350","77443","62003","6544338","1113438","0","10000","7667776","2096723","9764499","POINT (-95.6236852 43.3785704)"
"2022_CRAWFORD_REVS_SA","2022","24","CRAWFORD","9604067","11650","444800","9147617","12300","35500","835489","7268160","10250","1091700","202191","183254","18786461","3867500","0","250750","22904711","9481586","32386297","POINT (-95.3819678 42.0372125)"
"2015_DES MOINES_REVS_SA","2015","29","DES MOINES","13230468","19764","541186","12669518","5900","130800","2517403","6116941","50100","1005988","135963","362253","22994866","1830434","0","0","24825300","7275861","32101161","POINT (-91.1814707 40.9231829)"
"2021_MUSCATINE_REVS_SA","2021","70","MUSCATINE","18186163","0","1324950","16861213","2500","123500","2440765","10656827","98100","1044070","1093925","983600","33304500","3047084","2000000","11000","38362584","19533000","57895584","POINT (-91.1127562 41.4839221)"
"2015_UNION_REVS_SA","2015","88","UNION","5195447","0","203600","4991847","0","16100","1150106","4368630","32100","446340","55675","160850","11221648","891441","0","2000","12115089","3689387","15804476","POINT (-94.2423792 41.0277304)"
"2017_MUSCATINE_REVS_SA","2017","70","MUSCATINE","16652274","0","852600","15799674","4250","132000","2262148","8335075","86150","932728","533935","333875","28419835","2361000","1000000","46000","31826835","13422000","45248835","POINT (-91.1127562 41.4839221)"
"2020_CEDAR_REVS_SA","2020","16","CEDAR","9440992","0","501643","8939349","401","42200","972537","6000395","36919","1223359","113969","100316","17429445","2684567","35000","0","20149012","5690267","25839279","POINT (-91.1324125 41.7723207)"
"2011_CERRO GORDO_REVS_SA","2011","17","CERRO GORDO","14199555","10450","444350","13744755","1350","160000","2258364","14358641","395150","1127648","368228","844458","33258594","5363503","0","30000","38652097","11432523","50084620","POINT (-93.2608184 43.081557700000005)"
"2016_WAPELLO_REVS_SA","2016","90","WAPELLO","9321014","0","626620","8694394","6085","156800","3659719","4659292","60600","784097","238873","450686","18710546","1150000","0","34000","19894546","12835147","32729693","POINT (-92.4094499 41.03058450000001)"
"2017_GRUNDY_REVS_SA","2017","38","GRUNDY","5878599","0","321400","5557199","400","3000","589510","8237769","8150","314446","40775","160182","14911431","1626808","0","0","16538239","6304371","22842610","POINT (-92.7914177 42.4018651)"
"2012_CLARKE_REVS_SA","2012","20","CLARKE","4149636","2993","143249","4003394","960","45000","372007","3036361","15250","280790","26048","427760","8207570","599774","0","0","8807344","1632927","10440271","POINT (-93.78515790000002 41.0290323)"
"2012_POWESHIEK_REVS_SA","2012","79","POWESHIEK","6363525","258","178502","6184765","1405","60341","1149393","4554493","15620","429170","83358","336479","12815024","2056029","0","0","14871053","5475266","20346319","POINT (-92.53146840000001 41.6864422)"
"2020_POWESHIEK_REVS_SA","2020","79","POWESHIEK","7476394","0","254278","7222116","0","0","1274909","6006845","18100","645787","292280","1309658","16769695","2855688","0","0","19625383","10007939","29633322","POINT (-92.53146840000001 41.6864422)"
"2020_AUDUBON_REVS_SA","2020","5","AUDUBON","4400983","0","224000","4176983","0","0","785815","3338557","10000","227415","4050","11550","8554370","1156590","0","0","9710960","3811672","13522632","POINT (-94.9058222 41.6845893)"
"2013_BUTLER_REVS_SA","2013","12","BUTLER","5817430","0","199400","5618030","0","8000","747465","15305054","13800","501094","430672","188825","22812940","2103181","0","0","24916121","11861760","36777881","POINT (-92.7901934 42.7315661)"
"2017_JACKSON_REVS_SA","2017","49","JACKSON","6948293","0","385661","6562632","560","3800","975548","5510369","33860","600199","415882","195008","14297858","1035200","0","25","15333083","5729602","21062685","POINT (-90.5742294 42.1717426)"
"2020_SIOUX_REVS_SA","2020","84","SIOUX","11023828","0","657310","10366518","380","54300","2060891","8323629","19500","942145","225124","4200625","26193112","4400721","0","4250","30598083","19789841","50387924","POINT (-96.1778827 43.0826174)"
"2010_BENTON_REVS_SA","2010","6","BENTON","7247032","0","364010","6883022","15000","52100","836015","12645267","16500","735770","214001","332450","21730125","3453379","0","11500","25195004","6773053","31968057","POINT (-92.0656912 42.0801864)"
"2018_SCOTT_REVS_SA","2018","82","SCOTT","49262948","34166","2150368","47078414","34166","580000","7155718","13606716","670105","5781212","307945","785860","76000136","14317925","0","137000","90455061","29976524","120431585","POINT (-90.6232428 41.6370978)"
"2022_CHEROKEE_REVS_SA","2022","18","CHEROKEE","6195033","0","338004","5857029","0","10050","931084","4607924","65500","387880","110552","226220","12196239","2228787","0","2100","14427126","10413402","24840528","POINT (-95.6238055 42.7356226)"
"2014_KEOKUK_REVS_SA","2014","54","KEOKUK","4427864","130000","140000","4157864","1200","38000","147052","2966224","34500","549330","347361","125500","8367031","1309000","0","4000","9680031","4852356","14532387","POINT (-92.1786426 41.336465)"
"2011_CLAYTON_REVS_SA","2011","22","CLAYTON","7227118","0","328180","6898938","2615","59540","1261963","5423642","17450","413655","318179","244665","14640647","1400000","0","3000","16043647","6986135","23029782","POINT (-91.34143280000002 42.8447493)"
"2012_JASPER_REVS_SA","2012","50","JASPER","13129322","3950","439555","12685817","2270","100000","2052686","7592780","61000","859090","260160","480060","24093863","4751991","640000","4000","29489854","9068264","38558118","POINT (-93.053765 41.6860394)"
"2021_KEOKUK_REVS_SA","2021","54","KEOKUK","6294030","23050","335600","5935380","1000","41000","568602","4217790","49500","566320","145800","41500","11566892","2180955","15400","0","13763247","3888928","17652175","POINT (-92.1786426 41.336465)"
"2013_SHELBY_REVS_SA","2013","83","SHELBY","5636173","0","222900","5413273","0","30000","749663","4800107","229950","282075","95012","166706","11766786","2745610","0","0","14512396","3400257","17912653","POINT (-95.31021130000002 41.6850926)"
"2022_SCOTT_REVS_SA","2022","82","SCOTT","60116285","19716","2522030","57574539","19716","590000","7741243","12386584","864795","6746652","406705","1191040","87521274","15214555","0","160000","102895829","32954954","135850783","POINT (-90.6232428 41.6370978)"
"2018_TAYLOR_REVS_SA","2018","87","TAYLOR","4013557","3230","258692","3751635","715","18810","307332","5612331","5266","208656","40700","77468","10022913","825962","0","25500","10874375","3686785","14561160","POINT (-94.6964148 40.73743240000001)"
"2014_HOWARD_REVS_SA","2014","45","HOWARD","4748590","0","165955","4582635","70","0","1451513","3690933","4550","529637","96030","228412","10583780","1506581","0","30","12090391","3601911","15692302","POINT (-92.3171989 43.3567673)"
"2016_MAHASKA_REVS_SA","2016","62","MAHASKA","6587053","0","351823","6235230","1479","35900","1311519","4409811","12500","595300","218590","949340","13769669","2174530","0","0","15944199","8266418","24210617","POINT (-92.6409094 41.3352035)"
"2015_CERRO GORDO_REVS_SA","2015","17","CERRO GORDO","16110079","0","959000","15151079","13550","163000","2287708","8325154","131500","1312342","223745","1178661","28786739","5843316","0","10000","34640055","11766293","46406348","POINT (-93.2608184 43.081557700000005)"
"2016_CLAY_REVS_SA","2016","21","CLAY","7347169","600","440583","6905986","534","36900","1165999","4628295","19076","533860","318027","256454","13865131","2781558","0","0","16646689","6792648","23439337","POINT (-95.1509194 43.0825804)"
"2012_OSCEOLA_REVS_SA","2012","72","OSCEOLA","3062500","0","161000","2901500","7346","0","585886","2685276","12100","292875","125468","49540","6659991","1143359","0","0","7803350","2542369","10345719","POINT (-95.6236852 43.3785704)"
"2016_SIOUX_REVS_SA","2016","84","SIOUX","9256991","0","342800","8914191","650","53000","1967719","7132452","10250","675530","77874","423100","19254766","2899506","0","4500","22158772","11750419","33909191","POINT (-96.1778827 43.0826174)"
"2012_AUDUBON_REVS_SA","2012","5","AUDUBON","3533817","0","136300","3397517","0","0","337058","3048349","100","175590","15657","3480","6977751","691778","0","0","7669529","3180018","10849547","POINT (-94.9058222 41.6845893)"
"2016_APPANOOSE_REVS_SA","2016","4","APPANOOSE","3965548","0","327889","3637659","0","11000","1030025","3728059","3150","357845","13005","80610","8861353","771185","101000","0","9733538","6940572","16674110","POINT (-92.8686104 40.7431635)"
"2020_JOHNSON_REVS_SA","2020","52","JOHNSON","62344725","0","1929964","60414761","0","329000","876100","22378536","842999","4813698","1540213","1665384","92860691","17254135","21382000","209000","131705826","30239073","161944899","POINT (-91.5880849 41.6715511)"
"2018_MUSCATINE_REVS_SA","2018","70","MUSCATINE","16500100","0","1276750","15223350","4500","133000","2234087","8906085","95150","1039276","585528","237391","28458367","2611560","500000","37000","31606927","12899581","44506508","POINT (-91.1127562 41.4839221)"
"2021_STORY_REVS_SA","2021","85","STORY","28958362","0","1041733","27916629","3950","75000","3614316","9689543","79890","1913120","630840","593640","44516928","3526700","0","9500","48053128","24031193","72084321","POINT (-93.4650448 42.0362415)"
"2010_BUENA VISTA_REVS_SA","2010","11","BUENA VISTA","7830979","39741","269765","7521473","2125","42200","1001016","4878102","85505","566275","166169","24365","14287230","1803003","0","650","16090883","4063125","20154008","POINT (-95.15114900000002 42.7354936)"
"2020_VAN BUREN_REVS_SA","2020","89","VAN BUREN","3243817","3400","189450","3050967","1700","36000","382870","3677135","16150","230860","137050","167560","7700292","968216","0","750","8669258","5290884","13960142","POINT (-91.9499871 40.7532294)"
"2013_VAN BUREN_REVS_SA","2013","89","VAN BUREN","2579602","850","132600","2446152","850","36010","331995","3502929","27900","288690","155800","84750","6875076","635140","0","5350","7515566","2530555","10046121","POINT (-91.9499871 40.7532294)"
"2013_UNION_REVS_SA","2013","88","UNION","5385671","0","169050","5216621","3296","0","1116685","3439959","22330","403725","82935","192148","10477699","722856","0","0","11200555","5103521","16304076","POINT (-94.2423792 41.0277304)"
"2010_LINN_REVS_SA","2010","57","LINN","49335589","156699","1374880","47804010","64000","565000","2955767","54449342","733189","6226390","1260948","818711","114877357","14082103","0","4250","128963710","15841584","144805294","POINT (-91.5989646 42.0789478)"
"2021_JACKSON_REVS_SA","2021","49","JACKSON","7767079","0","460119","7306960","195","3100","980860","5969386","44360","607900","530009","214472","15657242","1341400","0","25","16998667","7374521","24373188","POINT (-90.5742294 42.1717426)"
"2015_GUTHRIE_REVS_SA","2015","39","GUTHRIE","4657318","0","127500","4529818","700","37000","608014","4547642","22900","574120","90550","447100","10857844","1656831","0","2750","12517425","5252006","17769431","POINT (-94.501055 41.6837548)"
"2015_LEE_REVS_SA","2015","56","LEE","10673531","0","572628","10100903","13648","115010","2213274","12991392","112700","999232","250595","9722439","36519193","1839775","0","500","38359468","7539193","45898661","POINT (-91.479264 40.6419764)"
"2011_HENRY_REVS_SA","2011","44","HENRY","6540272","0","276272","6264000","3467","53300","814647","4180474","39300","1371100","122214","215455","13063957","1043037","0","0","14106994","4943128","19050122","POINT (-91.5445241 40.9879383)"
"2015_BENTON_REVS_SA","2015","6","BENTON","8805701","2950","495300","8307451","2350","63000","1100529","6790504","52350","948165","247379","268650","17780378","4945555","41696","5000","22772629","13060125","35832754","POINT (-92.0656912 42.0801864)"
"2021_POCAHONTAS_REVS_SA","2021","76","POCAHONTAS","6952451","75","295875","6656501","75","11025","376875","5878879","22700","508780","157005","55150","13666990","1861945","0","15000","15543935","10644032","26187967","POINT (-94.67874660000001 42.73413510000001)"
"2018_BENTON_REVS_SA","2018","6","BENTON","9511329","0","667477","8843852","2553","63199","1065709","8209287","50650","785950","56689","327687","19405576","4341288","43807","9300","23799971","9182237","32982208","POINT (-92.0656912 42.0801864)"
"2017_CLINTON_REVS_SA","2017","23","CLINTON","17297043","0","921077","16375966","6050","136600","2668362","7947465","35975","1019547","192044","190050","28572059","1766659","0","0","30338718","6170123","36508841","POINT (-90.5319724 41.8980358)"
"2022_UNION_REVS_SA","2022","88","UNION","6139182","0","226150","5913032","4250","21475","906515","3307762","22250","471905","55720","65200","10768109","1171771","0","0","11939880","4439073","16378953","POINT (-94.2423792 41.0277304)"
"2014_POLK_REVS_SA","2014","77","POLK","136692801","563919","2625087","133503795","55300","1346000","5577304","45827851","588900","12466195","3144215","2721650","205231210","22916930","9930000","151000","238229140","54524707","292753847","POINT (-93.5735335 41.6855048)"
"2022_HUMBOLDT_REVS_SA","2022","46","HUMBOLDT","6589365","0","311520","6277845","350","15575","783061","3933319","10500","352370","152820","102170","11628010","1879085","200000","1000","13708095","5796858","19504953","POINT (-94.2071868 42.7764686)"
"2018_CLINTON_REVS_SA","2018","23","CLINTON","19347900","0","1056965","18290935","6050","136600","2681908","7656285","45950","1019895","201801","206104","30245528","2116276","0","0","32361804","12606940","44968744","POINT (-90.5319724 41.8980358)"
"2022_PAGE_REVS_SA","2022","73","PAGE","6463001","0","401675","6061326","1525","31040","809398","4251032","20400","319435","59061","284534","11837751","1589434","0","20000","13447185","7013619","20460804","POINT (-95.1501747 40.7391444)"
"2017_BENTON_REVS_SA","2017","6","BENTON","9165109","0","643150","8521959","2500","62000","1072634","8137436","50065","772350","87414","306565","19012923","4285146","42739","7800","23348608","10763916","34112524","POINT (-92.0656912 42.0801864)"
"2017_KOSSUTH_REVS_SA","2017","55","KOSSUTH","8391286","0","466914","7924372","0","36050","1095337","7212660","14350","597450","172289","78370","17130878","2821373","20957","50000","20023208","8166354","28189562","POINT (-94.2067199 43.20413)"
"2019_CLINTON_REVS_SA","2019","23","CLINTON","19440060","0","596332","18843728","5050","136400","2662373","7218760","46950","991045","271400","204830","30380536","3978209","0","0","34358745","21256397","55615142","POINT (-90.5319724 41.8980358)"
"2019_KOSSUTH_REVS_SA","2019","55","KOSSUTH","8874500","0","502447","8372053","0","34025","1501024","7232585","14900","616900","167536","71750","18010773","2865759","20957","10000","20907489","8681914","29589403","POINT (-94.2067199 43.20413)"
"2020_PALO ALTO_REVS_SA","2020","74","PALO ALTO","7070228","3750","350900","6715578","0","12000","1751497","4240152","16350","667867","71090","297574","13772108","2827804","0","0","16599912","11304274","27904186","POINT (-94.6781371 43.0820643)"
"2013_HENRY_REVS_SA","2013","44","HENRY","7061822","0","263546","6798276","3467","53300","892964","3580792","51550","465670","57067","42250","11945336","1106292","0","1220000","14271628","4976336","19247964","POINT (-91.5445241 40.9879383)"
"2015_HENRY_REVS_SA","2015","44","HENRY","7228251","0","263546","6964705","3467","53300","915221","3469135","60100","478320","52950","156050","12153248","1343137","0","0","13496385","6494454","19990839","POINT (-91.5445241 40.9879383)"
"2011_KOSSUTH_REVS_SA","2011","55","KOSSUTH","7919353","0","392750","7526603","0","30300","939442","6841571","8200","625959","241434","149184","16362693","2887951","0","10000","19260644","6558714","25819358","POINT (-94.2067199 43.20413)"
"2022_FRANKLIN_REVS_SA","2022","35","FRANKLIN","8610486","1000","390288","8219198","268","14100","3250339","6205336","23250","506630","107640","55695","18382456","2995497","0","50000","21427953","10799932","32227885","POINT (-93.262473 42.7325458)"
"2019_HAMILTON_REVS_SA","2019","40","HAMILTON","7987478","5000","461155","7521323","0","31600","1292373","6248909","19075","2305105","243048","2604937","20266370","3180581","0","13100","23460051","5325127","28785178","POINT (-93.7068085 42.3837722)"
"2016_POLK_REVS_SA","2016","77","POLK","147131853","606758","6069495","140455600","800","1282000","5869317","54656795","891150","13154750","3123226","2605590","222039228","23030356","33976156","105000","279150740","82309888","361460628","POINT (-93.5735335 41.6855048)"
"2018_GRUNDY_REVS_SA","2018","38","GRUNDY","6119664","0","349500","5770164","0","3000","571098","7651905","7650","351391","54775","132706","14542689","1849100","0","0","16391789","5839893","22231682","POINT (-92.7914177 42.4018651)"
"2011_POCAHONTAS_REVS_SA","2011","76","POCAHONTAS","4303828","1000","200500","4102328","950","18000","415114","3867154","28700","396050","152872","39625","9020793","1100000","0","0","10120793","3247857","13368650","POINT (-94.67874660000001 42.73413510000001)"
"2021_BLACK HAWK_REVS_SA","2021","7","BLACK HAWK","38138954","0","1851985","36286969","5000","322000","4446353","12779323","629225","4090079","964525","2736947","62260421","12355097","4000000","6553","78622071","34495385","113117456","POINT (-92.3088197 42.4700957)"
"2014_BREMER_REVS_SA","2014","9","BREMER","7260625","0","241362","7019263","14000","0","1209821","4211334","277100","830430","272309","337129","14171386","2957085","0","750","17129221","9301934","26431155","POINT (-92.31805480000001 42.7745873)"
"2022_BREMER_REVS_SA","2022","9","BREMER","8825035","0","484918","8340117","130","45400","1408024","8009888","305430","874575","355899","400950","19740413","3273090","0","17300","23030803","14205873","37236676","POINT (-92.31805480000001 42.7745873)"
"2019_BOONE_REVS_SA","2019","8","BOONE","8055693","1595","424214","7629884","1610","65200","1484793","5813674","30800","1035168","162500","575200","16798829","3230276","0","10000","20039105","5801376","25840481","POINT (-93.931671 42.0365493)"
"2011_TAYLOR_REVS_SA","2011","87","TAYLOR","2590555","5100","152449","2433006","910","4510","244998","4185876","11550","121500","63905","60383","7126638","689070","0","0","7815708","1947287","9762995","POINT (-94.6964148 40.73743240000001)"
"2020_BUTLER_REVS_SA","2020","12","BUTLER","6754361","0","461050","6293311","2300","34200","1435054","5725824","39000","503056","273186","449350","14755281","3198302","0","0","17953583","9617235","27570818","POINT (-92.7901934 42.7315661)"
"2022_LEE_REVS_SA","2022","56","LEE","13315240","0","900335","12414905","9923","144000","2859113","11655814","313350","1084139","409482","2019754","30910480","2611758","0","0","33522238","16170784","49693022","POINT (-91.479264 40.6419764)"
"2021_GUTHRIE_REVS_SA","2021","39","GUTHRIE","7891083","0","158950","7732133","700","38000","1871408","5437176","49200","891800","165180","546350","16731947","2429627","399983","500","19562057","4370730","23932787","POINT (-94.501055 41.6837548)"
"2010_HARRISON_REVS_SA","2010","43","HARRISON","6365269","6750","302000","6056519","3200","51300","635868","7044707","29154","462875","337380","1604035","16225038","1294530","0","0","17519568","7044477","24564045","POINT (-95.8169209 41.6828528)"
"2017_WAPELLO_REVS_SA","2017","90","WAPELLO","9549419","0","626620","8922799","6085","156800","3149986","5146446","60650","834367","237777","397120","18912030","1150000","0","9000","20071030","9992653","30063683","POINT (-92.4094499 41.03058450000001)"
"2017_CERRO GORDO_REVS_SA","2017","17","CERRO GORDO","16725273","0","810446","15914827","16400","165000","2719238","8823443","129600","1249350","209570","1652073","30879501","6721071","0","0","37600572","14032124","51632696","POINT (-93.2608184 43.081557700000005)"
"2018_JASPER_REVS_SA","2018","50","JASPER","14484431","131000","619000","13734431","100","66200","2142193","6884399","95750","967232","115690","373501","24379496","4247438","0","1420000","30046934","9830681","39877615","POINT (-93.053765 41.6860394)"
"2014_CLAYTON_REVS_SA","2014","22","CLAYTON","7903341","0","324334","7579007","1322","58300","1353253","5394426","24575","520600","213761","1245123","16390367","1600000","0","10000","18000367","6297135","24297502","POINT (-91.34143280000002 42.8447493)"
"2010_DALLAS_REVS_SA","2010","25","DALLAS","18907425","0","408610","18498815","1071","69690","696951","9095144","159500","1908672","625988","393702","31449533","6338371","0","0","37787904","9848378","47636282","POINT (-94.0397374 41.6848862)"
"2019_SHELBY_REVS_SA","2019","83","SHELBY","6293261","0","297200","5996061","200","30000","740124","4657149","143941","308215","52009","86900","12014599","2901399","0","0","14915998","4190229","19106227","POINT (-95.31021130000002 41.6850926)"
"2018_WEBSTER_REVS_SA","2018","94","WEBSTER","12184686","0","768931","11415755","0","0","3954404","13143170","69775","977260","208715","608600","30377679","5314538","0","480000","36172217","16611669","52783886","POINT (-94.18178810000002 42.4279662)"
"2020_LINN_REVS_SA","2020","57","LINN","68852885","214511","2965140","65673234","18400","588000","8518752","27281239","1262230","7837690","2157370","1367680","114704595","26143354","31500000","41900","172389849","50309828","222699677","POINT (-91.5989646 42.0789478)"
"2012_WARREN_REVS_SA","2012","91","WARREN","11489515","10818","341169","11137528","4700","144400","430503","7998288","58800","1213757","101325","439780","21529081","2482000","0","31000","24042081","6768892","30810973","POINT (-93.5613594 41.3343735)"
"2013_AUDUBON_REVS_SA","2013","5","AUDUBON","3948014","0","138500","3809514","0","0","321905","3176275","500","177745","19150","23130","7528219","755090","0","0","8283309","3195482","11478791","POINT (-94.9058222 41.6845893)"
"2013_CRAWFORD_REVS_SA","2013","24","CRAWFORD","7704919","18419","256000","7430500","1900","47700","720616","6690357","5500","672595","141867","142950","15853985","2298000","0","230900","18382885","6559938","24942823","POINT (-95.3819678 42.0372125)"
"2015_O'BRIEN_REVS_SA","2015","71","O'BRIEN","5927333","0","395739","5531594","0","17504","892633","4721337","119000","432448","154788","118467","11987771","2454683","0","0","14442454","4901046","19343500","POINT (-95.6248784 43.0837527)"
"2014_HANCOCK_REVS_SA","2014","41","HANCOCK","5042090","1400","135000","4905690","1050","35000","519559","3665381","25406","343440","250625","174100","9920251","2085000","0","0","12005251","3120325","15125576","POINT (-93.7342723 43.0818861)"
"2010_GRUNDY_REVS_SA","2010","38","GRUNDY","4829606","0","246900","4582706","0","0","453207","4451868","7450","281615","122050","545945","10444841","1077600","0","0","11522441","4934741","16457182","POINT (-92.7914177 42.4018651)"
"2022_POTTAWATTAMIE_REVS_SA","2022","78","POTTAWATTAMIE","46829015","0","1729900","45099115","3000","147000","7814924","21618665","307300","2822475","335455","2339800","80487734","8195450","0","600000","89283184","46541428","135824612","POINT (-95.5423935 41.3366123)"
"2022_HANCOCK_REVS_SA","2022","41","HANCOCK","5994460","0","0","5994460","430","13000","741401","5428614","19400","387445","292289","110800","12987839","2728600","0","0","15716439","7675575","23392014","POINT (-93.7342723 43.0818861)"
"2010_DAVIS_REVS_SA","2010","26","DAVIS","2931174","7359","157520","2766295","186","31182","430454","3359889","1268","178914","199701","282119","7250008","625566","0","0","7875574","2720193","10595767","POINT (-92.4097173 40.7476891)"
"2022_MONONA_REVS_SA","2022","67","MONONA","7507846","0","0","7507846","935","10920","475785","5838199","8600","301342","85000","139166","14367793","1578086","0","50000","15995879","5593000","21588879","POINT (-95.9599235 42.0516663)"
"2016_LOUISA_REVS_SA","2016","58","LOUISA","4893450","13800","333664","4545986","4000","41000","1447639","4849642","18550","606752","34620","25850","11574039","1718062","0","0","13292101","5510832","18802933","POINT (-91.2596184 41.2185073)"
"2012_LYON_REVS_SA","2012","60","LYON","5061326","0","205170","4856156","0","19050","616119","5395473","70686","706910","176065","81212","11921671","1612928","0","0","13534599","4340472","17875071","POINT (-96.2102924 43.380497)"
"2013_WAYNE_REVS_SA","2013","93","WAYNE","3190105","19300","142600","3028205","4370","0","429694","3468493","5830","330330","30500","30450","7327872","627300","0","0","7955172","1881058","9836230","POINT (-93.3273639 40.73947020000001)"
"2010_JONES_REVS_SA","2010","53","JONES","5684103","807","291583","5391713","550","45300","914391","6568497","66655","515455","223051","327845","14053457","1808000","0","11800","15873257","4235495","20108752","POINT (-91.1314352 42.1212397)"
"2020_MITCHELL_REVS_SA","2020","66","MITCHELL","5727121","0","279660","5447461","0","26000","4444830","5242429","7000","783935","250250","67600","16269505","1412875","0","1000","17683380","5067603","22750983","POINT (-92.7890315 43.3564124)"
"2017_EMMET_REVS_SA","2017","32","EMMET","4669152","210","257395","4411547","250","12950","386754","3086626","9300","326727","22851","244825","8501830","1040969","0","0","9542799","4220864","13763663","POINT (-94.6784803 43.37802250000001)"
"2010_CASS_REVS_SA","2010","15","CASS","4381148","450","120565","4260133","1153","36410","930379","6615798","14710","329940","202445","581545","12972513","1688771","0","0","14661284","2599724","17261008","POINT (-94.9278266 41.3314876)"
"2015_POCAHONTAS_REVS_SA","2015","76","POCAHONTAS","6468270","0","220595","6247675","500","15750","487438","3788281","11700","379610","140150","62450","11133554","1110000","0","0","12243554","5412819","17656373","POINT (-94.67874660000001 42.73413510000001)"
"2011_TAMA_REVS_SA","2011","86","TAMA","7217407","5149","367383","6844875","1700","42000","709367","6271508","15000","514581","123633","314504","14837168","1791564","0","4450","16633182","5717198","22350380","POINT (-92.5325425 42.07981170000001)"
"2017_DECATUR_REVS_SA","2017","27","DECATUR","3547269","0","1","3547268","0","32400","317706","3730816","9088","277370","15000","179730","8109378","485000","0","0","8594378","1744480","10338858","POINT (-93.7862815 40.7376827)"
"2017_WAYNE_REVS_SA","2017","93","WAYNE","3702690","66130","165730","3470830","3325","41750","347079","4389795","4200","413468","104587","79260","8854294","525000","0","0","9379294","5375595","14754889","POINT (-93.3273639 40.73947020000001)"
"2013_POCAHONTAS_REVS_SA","2013","76","POCAHONTAS","5776503","1000","186294","5589209","950","24000","444997","4467050","29900","435360","129510","49850","11170826","1200000","0","10000","12380826","1698212","14079038","POINT (-94.67874660000001 42.73413510000001)"
"2015_BUCHANAN_REVS_SA","2015","10","BUCHANAN","7207617","36475","432350","6738792","673","26000","1121040","6313492","34090","594780","254600","121280","15204747","2346477","0","18000","17569224","5886418","23455642","POINT (-91.8378392 42.4707777)"
"2011_BUTLER_REVS_SA","2011","12","BUTLER","5107459","0","211950","4895509","0","8000","624244","29563733","13000","551690","359064","172947","36188187","1558991","0","0","37747178","5552557","43299735","POINT (-92.7901934 42.7315661)"
"2022_POLK_REVS_SA","2022","77","POLK","203264228","852020","8363310","194048898","23500","1225000","6014803","48552557","1301950","16991918","6670689","1727900","276557215","73036011","0","49000","349642226","102548433","452190659","POINT (-93.5735335 41.6855048)"
"2015_WAYNE_REVS_SA","2015","93","WAYNE","3433233","25520","214660","3193053","4880","0","401085","3036637","53330","429725","8538","284000","7411248","495604","0","0","7906852","4206139","12112991","POINT (-93.3273639 40.73947020000001)"
"2016_DAVIS_REVS_SA","2016","26","DAVIS","3279522","0","207483","3072039","530","15110","588303","3690889","800","170994","119737","177608","7836010","804843","0","0","8640853","2110201","10751054","POINT (-92.4097173 40.7476891)"
"2018_IDA_REVS_SA","2018","47","IDA","2367678","0","143560","2224118","100","10000","550691","3028298","10700","228435","15035","305325","6372702","1248456","0","0","7621158","2682593","10303751","POINT (-95.5134962 42.3868747)"
"2019_DECATUR_REVS_SA","2019","27","DECATUR","4407142","0","221600","4185542","0","32000","324521","3728517","88","264115","5000","81170","8620953","535355","0","0","9156308","2359550","11515858","POINT (-93.7862815 40.7376827)"
"2017_BUCHANAN_REVS_SA","2017","10","BUCHANAN","7162222","14150","509300","6638772","3200","55000","1080714","6388454","31450","566092","249100","118160","15130942","2589477","0","18500","17738919","8363207","26102126","POINT (-91.8378392 42.4707777)"
"2017_LUCAS_REVS_SA","2017","59","LUCAS","3637578","0","200825","3436753","1110","21000","602197","3675702","450","222750","13020","38264","8011246","606130","150000","0","8767376","2167133","10934509","POINT (-93.3277207 41.0293738)"
"2018_BUENA VISTA_REVS_SA","2018","11","BUENA VISTA","9495450","47477","556732","8891241","505","16300","1061257","5429198","82245","659665","111025","177507","16428943","2553224","2000000","300","20982467","9977258","30959725","POINT (-95.15114900000002 42.7354936)"
"2011_DECATUR_REVS_SA","2011","27","DECATUR","2436121","2330","95552","2338239","1185","30500","263030","4461795","4188","199360","19450","421734","7739481","443376","146000","0","8328857","1408116","9736973","POINT (-93.7862815 40.7376827)"
"2013_IOWA_REVS_SA","2013","48","IOWA","6841191","6950","235167","6599074","1925","36250","2553955","4641401","27600","980500","372557","157830","15371092","1274698","0","0","16645790","5747832","22393622","POINT (-92.065524 41.6863229)"
"2022_WASHINGTON_REVS_SA","2022","92","WASHINGTON","12050753","0","724416","11326337","2531","53500","2082031","7195820","79750","2127825","217583","1445465","24530842","2860199","5242","250","27396533","10207032","37603565","POINT (-91.7178676 41.335591)"
"2019_HENRY_REVS_SA","2019","44","HENRY","8031241","0","450685","7580556","1607","53300","913057","4783964","24400","515830","105330","115900","14093944","1540944","0","0","15634888","15305766","30940654","POINT (-91.5445241 40.9879383)"
"2013_MADISON_REVS_SA","2013","61","MADISON","4816474","0","155498","4660976","0","69471","974974","4286320","45600","930895","90548","56804","11115588","1613403","0","2500","12731491","3247672","15979163","POINT (-94.01556190000001 41.33071420000001)"
"2022_APPANOOSE_REVS_SA","2022","4","APPANOOSE","4479727","0","357050","4122677","0","12000","1368480","3910142","4150","330750","50775","42690","9841664","913054","104430","0","10859148","15102297","25961445","POINT (-92.8686104 40.7431635)"
"2011_WORTH_REVS_SA","2011","98","WORTH","3857925","2222","204982","3650721","345","24013","1931293","2908056","28759","266389","215241","729383","9754200","938750","0","16970","10709920","4977055","15686975","POINT (-93.2608476 43.3773984)"
"2020_MUSCATINE_REVS_SA","2020","70","MUSCATINE","18215116","0","1324950","16890166","2500","123500","2417180","8790005","96600","1049950","1102461","975900","31448262","2544710","1850000","19000","35861972","16447000","52308972","POINT (-91.1127562 41.4839221)"
"2021_HENRY_REVS_SA","2021","44","HENRY","9702541","0","541645","9160896","1607","53300","1020310","6688646","180012","686670","118805","209000","18119246","1760722","0","0","19879968","3963033","23843001","POINT (-91.5445241 40.9879383)"
"2019_LUCAS_REVS_SA","2019","59","LUCAS","3500590","0","196295","3304295","1800","22000","580449","3956700","450","322340","56000","492264","8736298","708918","0","500","9445716","2325460","11771176","POINT (-93.3277207 41.0293738)"
"2015_IOWA_REVS_SA","2015","48","IOWA","7175725","6950","431726","6737049","3645","36250","2046421","4997342","29350","1027190","359951","159750","15396948","1315000","0","0","16711948","8105299","24817247","POINT (-92.065524 41.6863229)"
"2014_MILLS_REVS_SA","2014","65","MILLS","7306137","0","232523","7073614","0","62700","1132527","4250835","151200","405480","91249","172725","13340330","7528000","6550000","7000","27425330","5036240","32461570","POINT (-95.62132670000001 41.0334523)"
"2011_LUCAS_REVS_SA","2011","59","LUCAS","3147500","1050","148630","2997820","690","9000","349725","3598916","450","240317","42150","81005","7320073","749686","0","200","8069959","2104837","10174796","POINT (-93.3277207 41.0293738)"
"2018_DAVIS_REVS_SA","2018","26","DAVIS","4248600","0","234069","4014531","1019","20550","588692","4524563","1293","194677","148078","193771","9687174","801300","0","0","10488474","1793276","12281750","POINT (-92.4097173 40.7476891)"
"2019_BUTLER_REVS_SA","2019","12","BUTLER","6785120","0","465000","6320120","3000","34200","1462317","6842864","42500","494251","310059","253890","15763201","3161615","0","0","18924816","8584198","27509014","POINT (-92.7901934 42.7315661)"
"2015_MILLS_REVS_SA","2015","65","MILLS","7559713","0","225518","7334195","0","57606","1264038","4538482","145075","480460","88596","120649","14029101","2196815","0","8000","16233916","8179385","24413301","POINT (-95.62132670000001 41.0334523)"
"2016_HOWARD_REVS_SA","2016","45","HOWARD","5044744","0","289200","4755544","1250","10100","2357156","3815958","12500","525523","126028","204514","11808573","1681412","0","0","13489985","5626064","19116049","POINT (-92.3171989 43.3567673)"
"2018_MAHASKA_REVS_SA","2018","62","MAHASKA","8225398","0","357659","7867739","1150","40900","1342387","4909504","25600","610425","131801","470050","15399556","3713254","1690000","10000","20812810","10250849","31063659","POINT (-92.6409094 41.3352035)"
"2020_WORTH_REVS_SA","2020","98","WORTH","4813038","25453","324762","4462823","41","34475","4474114","4298768","116050","301546","191533","7900","13887250","1231732","0","1800","15120782","8954768","24075550","POINT (-93.2608476 43.3773984)"
"2011_WARREN_REVS_SA","2011","91","WARREN","11367761","6228","400974","10960559","6200","140800","413679","8598333","53750","1165939","133582","520904","21993746","2321706","0","23000","24338452","6999159","31337611","POINT (-93.5613594 41.3343735)"
"2010_CLAY_REVS_SA","2010","21","CLAY","6164146","925","231466","5931755","925","3000","995955","4452102","22822","428944","257741","1028170","13121414","2400320","0","0","15521734","5334389","20856123","POINT (-95.1509194 43.0825804)"
"2021_LUCAS_REVS_SA","2021","59","LUCAS","3635729","0","225200","3410529","7400","23000","640863","3010321","250","270310","75000","330364","7768037","782660","0","500","8551197","2209814","10761011","POINT (-93.3277207 41.0293738)"
"2022_LYON_REVS_SA","2022","60","LYON","6965773","0","355130","6610643","0","25070","2132481","6096634","76600","1029325","210461","51590","16232804","3525452","0","1000","19759256","8181738","27940994","POINT (-96.2102924 43.380497)"
"2014_DAVIS_REVS_SA","2014","26","DAVIS","3087735","0","116385","2971350","1005","36170","697359","3282204","200","173914","82165","387006","7631373","769103","0","0","8400476","2149749","10550225","POINT (-92.4097173 40.7476891)"
"2018_POWESHIEK_REVS_SA","2018","79","POWESHIEK","7398856","0","254278","7144578","32","50834","1176844","5157241","24425","474800","59950","514621","14603325","2566255","0","0","17169580","8930161","26099741","POINT (-92.53146840000001 41.6864422)"
"2010_IDA_REVS_SA","2010","47","IDA","2600186","710","111000","2488476","200","2000","215798","2552673","16331","196060","52525","115025","5639088","825000","0","100","6464188","2327290","8791478","POINT (-95.5134962 42.3868747)"
"2019_POWESHIEK_REVS_SA","2019","79","POWESHIEK","7409775","0","254278","7155497","0","0","1145104","6278517","54650","689690","140310","252446","15716214","2785188","0","0","18501402","9886893","28388295","POINT (-92.53146840000001 41.6864422)"
"2010_WEBSTER_REVS_SA","2010","94","WEBSTER","10564309","0","364366","10199943","9780","115000","2771002","10075109","40677","923795","618850","135229","24889385","1950000","0","0","26839385","9165368","36004753","POINT (-94.18178810000002 42.4279662)"
"2016_CALHOUN_REVS_SA","2016","13","CALHOUN","5958256","0","303000","5655256","880","25000","486795","4006346","16050","1163400","122100","92150","11567977","1465156","0","5000","13038133","9510836","22548969","POINT (-94.6404136 42.385184800000005)"
"2020_CRAWFORD_REVS_SA","2020","24","CRAWFORD","9222971","2300","454450","8766221","1700","47300","795553","6933780","3500","1141503","98483","141458","17929498","3499400","0","255500","21684398","7837352","29521750","POINT (-95.3819678 42.0372125)"
"2012_TAYLOR_REVS_SA","2012","87","TAYLOR","2683188","5100","135161","2542927","1000","4510","249693","3629695","13700","131325","64905","84653","6722408","713584","0","0","7435992","2280813","9716805","POINT (-94.6964148 40.73743240000001)"
"2017_POTTAWATTAMIE_REVS_SA","2017","78","POTTAWATTAMIE","42168662","0","1461900","40706762","12600","317000","8234675","18755519","284925","2288675","108855","3418200","74127211","9425000","0","0","83552211","24992256","108544467","POINT (-95.5423935 41.3366123)"
"2018_WAPELLO_REVS_SA","2018","90","WAPELLO","10018438","0","789726","9228712","6085","16800","3113853","5079442","67150","757725","246204","458548","18974519","1150000","0","5000","20129519","12638104","32767623","POINT (-92.4094499 41.03058450000001)"
"2014_CLAY_REVS_SA","2014","21","CLAY","7261531","825","330077","6930629","325","41000","1150166","3927436","32129","501232","302427","423019","13308363","1697782","0","0","15006145","6829421","21835566","POINT (-95.1509194 43.0825804)"
"2021_DECATUR_REVS_SA","2021","27","DECATUR","4339049","0","254100","4084949","0","30000","307978","3773831","400","276215","16000","72300","8561673","648712","0","0","9210385","3267249","12477634","POINT (-93.7862815 40.7376827)"
"2013_DES MOINES_REVS_SA","2013","29","DES MOINES","12553138","9147","374965","12169026","6735","142900","2633192","7433376","47625","1027760","166249","379650","24006513","1725196","0","0","25731709","5224192","30955901","POINT (-91.1814707 40.9231829)"
"2011_KEOKUK_REVS_SA","2011","54","KEOKUK","4848053","0","140000","4708053","3400","31005","163768","3283872","26600","562412","493429","138750","9411289","1004000","0","0","10415289","5611592","16026881","POINT (-92.1786426 41.336465)"
"2012_DUBUQUE_REVS_SA","2012","31","DUBUQUE","26615686","6323","685498","25923865","6323","224999","4805218","17375613","59300","3602561","288676","249093","52535648","5263269","2437500","0","60236417","12796262","73032679","POINT (-90.8824564 42.468832)"
"2012_WASHINGTON_REVS_SA","2012","92","WASHINGTON","8721637","0","376478","8345159","1377","60050","3459662","6313337","52550","691085","160656","609070","19692946","2339428","0","0","22032374","11814065","33846439","POINT (-91.7178676 41.335591)"
"2014_JONES_REVS_SA","2014","53","JONES","7275739","1030","347955","6926754","800","42250","967461","5218765","72923","561960","182729","544235","14517877","1790000","0","0","16307877","3581896","19889773","POINT (-91.1314352 42.1212397)"
"2010_LOUISA_REVS_SA","2010","58","LOUISA","4315559","2800","169140","4143619","2900","28000","988701","4186954","18475","560850","83697","184309","10197505","2208059","0","0","12405564","4621592","17027156","POINT (-91.2596184 41.2185073)"
"2013_CLARKE_REVS_SA","2013","20","CLARKE","4167159","2993","148170","4015996","960","45000","365711","3711060","20550","293875","30550","208589","8692291","617631","0","0","9309922","2648681","11958603","POINT (-93.78515790000002 41.0290323)"
"2010_POWESHIEK_REVS_SA","2010","79","POWESHIEK","5413729","2730","182015","5228984","9374","52631","1830958","5417909","84975","499503","371221","223423","13718978","1887370","0","0","15606348","9263456","24869804","POINT (-92.53146840000001 41.6864422)"
"2021_BUTLER_REVS_SA","2021","12","BUTLER","7474080","0","458000","7016080","650","33700","1585296","5726688","47000","527414","309566","616069","15862463","3866724","0","0","19729187","8020144","27749331","POINT (-92.7901934 42.7315661)"
"2012_MARSHALL_REVS_SA","2012","64","MARSHALL","11920018","0","426426","11493592","1800","12000","1976093","7986206","41750","711575","298205","103940","22625161","2255900","0","10000","24891061","8242484","33133545","POINT (-92.9987706 42.0358499)"
"2022_HOWARD_REVS_SA","2022","45","HOWARD","6266461","0","340585","5925876","675","11848","1632616","5030676","21000","494290","135430","130312","13382723","2125179","0","0","15507902","5852627","21360529","POINT (-92.3171989 43.3567673)"
"2010_DICKINSON_REVS_SA","2010","30","DICKINSON","6616737","10216","102404","6504117","10216","52900","1784415","4164412","69050","676983","327677","366443","13956213","2379581","0","2000","16337794","8127022","24464816","POINT (-95.1508301 43.3779848)"
"2012_CHICKASAW_REVS_SA","2012","19","CHICKASAW","4202942","2325","130975","4069642","250","4250","726293","5130349","7030","768806","55832","142500","10904952","2206208","0","500","13111660","6089419","19201079","POINT (-92.3176637 43.06004140000001)"
"2014_RINGGOLD_REVS_SA","2014","80","RINGGOLD","2766573","0","79470","2687103","1000","25100","380577","3838454","4125","541749","15200","910360","8403668","714738","0","0","9118406","3033061","12151467","POINT (-94.2439719 40.7352023)"
"2019_FLOYD_REVS_SA","2019","34","FLOYD","6178800","0","360314","5818486","0","12000","1531148","6767301","26020","474320","218665","209750","15057690","1313315","0","0","16371005","7904581","24275586","POINT (-92.78900330000002 43.0599208)"
"2014_WOODBURY_REVS_SA","2014","97","WOODBURY","26785261","0","780063","26005198","7200","447858","5515068","11107256","235675","2198800","283142","524700","46324897","7774266","1270000","0","55369163","10825723","66194886","POINT (-96.0447673 42.3897169)"
"2011_MITCHELL_REVS_SA","2011","66","MITCHELL","4489177","0","224520","4264657","0","20300","569927","4350574","4500","1011370","156996","132700","10511024","1550372","5000","0","12066396","2503168","14569564","POINT (-92.7890315 43.3564124)"
"2017_MARSHALL_REVS_SA","2017","64","MARSHALL","12448126","0","834093","11614033","0","80000","2012526","7564130","42208","728025","198176","678815","22917913","2532000","0","10000","25459913","9256857","34716770","POINT (-92.9987706 42.0358499)"
"2017_WOODBURY_REVS_SA","2017","97","WOODBURY","29229268","0","1118157","28111111","15000","356000","6410431","9467132","763450","2223734","279500","218900","47845258","9399770","5719302","0","62964330","13563762","76528092","POINT (-96.0447673 42.3897169)"
"2011_SAC_REVS_SA","2011","81","SAC","4371818","3211","1000","4367607","2269","29695","500869","3922287","16350","865015","102979","17193","9824264","1133915","0","0","10958179","2621966","13580145","POINT (-95.1053946 42.3862604)"
"2015_WOODBURY_REVS_SA","2015","97","WOODBURY","28333075","0","880775","27452300","8700","422500","5920872","11280857","30550","2275300","265292","266400","47922771","8674970","839000","0","57436741","13572927","71009668","POINT (-96.0447673 42.3897169)"
"2014_IOWA_REVS_SA","2014","48","IOWA","7255061","6950","301766","6946345","3645","36250","2289755","4250022","27650","1053870","364321","156630","15128488","1286000","0","0","16414488","6961999","23376487","POINT (-92.065524 41.6863229)"
"2020_JEFFERSON_REVS_SA","2020","51","JEFFERSON","7810086","5400","375000","7429686","1120","55500","815070","3888792","34000","2305720","47000","58647","14635535","1000000","7760000","0","23395535","4626937","28022472","POINT (-91.9488774 41.0317596)"
"2021_CLAY_REVS_SA","2021","21","CLAY","8681164","5877","455608","8219679","350","32460","1352896","5837162","32790","645923","426353","141450","16689063","3018205","0","0","19707268","8265982","27973250","POINT (-95.1509194 43.0825804)"
"2013_DALLAS_REVS_SA","2013","25","DALLAS","19124908","0","4","19124904","0","154000","617530","10556484","111527","2260435","355275","340326","33520481","3808462","0","0","37328943","19062835","56391778","POINT (-94.0397374 41.6848862)"
"2013_RINGGOLD_REVS_SA","2013","80","RINGGOLD","2701718","0","97770","2603948","1150","27050","286546","3253721","4125","488589","14202","861141","7540472","730816","0","0","8271288","3265402","11536690","POINT (-94.2439719 40.7352023)"
"2016_DICKINSON_REVS_SA","2016","30","DICKINSON","8917593","20100","253951","8643542","20100","42100","1948386","4432875","63100","677430","227080","390525","16445138","3067227","100","1000","19513465","10580888","30094353","POINT (-95.1508301 43.3779848)"
"2012_CARROLL_REVS_SA","2012","14","CARROLL","6122490","0","179075","5943415","0","22000","1092379","5166174","94300","1794830","264976","562235","14940309","1880000","0","0","16820309","9193405","26013714","POINT (-94.8605593 42.0362382)"
"2016_JONES_REVS_SA","2016","53","JONES","7778652","1027","470673","7306952","1150","44800","1026037","6171146","69495","555105","183528","321909","15680122","2035000","0","0","17715122","5572957","23288079","POINT (-91.1314352 42.1212397)"
"2012_LEE_REVS_SA","2012","56","LEE","9797513","0","430087","9367426","7296","111606","2266140","8993237","114200","938347","268580","144370","22211202","1310000","0","0","23521202","7166993","30688195","POINT (-91.479264 40.6419764)"
"2014_WAPELLO_REVS_SA","2014","90","WAPELLO","9546687","77500","468792","9000395","6085","141000","2237601","3978720","55100","820627","234178","983573","17457279","1500000","0","9000","18966279","6997382","25963661","POINT (-92.4094499 41.03058450000001)"
"2021_IOWA_REVS_SA","2021","48","IOWA","9337809","805","548128","8788876","955","28800","1810343","9492088","35582","2034740","368250","78421","22638055","1315000","58000","0","24011055","8280667","32291722","POINT (-92.065524 41.6863229)"
"2018_HARRISON_REVS_SA","2018","43","HARRISON","8157591","2750","472700","7682141","2850","60500","666098","5336809","34050","640335","122525","487625","15032933","2197000","0","0","17229933","10289899","27519832","POINT (-95.8169209 41.6828528)"
"2011_BOONE_REVS_SA","2011","8","BOONE","7334862","5600","265601","7063661","8500","80000","1088657","8148251","14300","908410","254255","520300","18086334","2135363","498000","10000","20729697","4864377","25594074","POINT (-93.931671 42.0365493)"
"2012_HANCOCK_REVS_SA","2012","41","HANCOCK","4071259","3280","78500","3989479","1040","36500","383945","5098761","26355","442265","223174","223655","10425174","2015000","0","0","12440174","5262720","17702894","POINT (-93.7342723 43.0818861)"
"2011_CLINTON_REVS_SA","2011","23","CLINTON","15724487","0","597050","15127437","21000","137000","2456295","11045484","160370","956003","319229","259720","30482538","975000","4155000","0","35612538","17368670","52981208","POINT (-90.5319724 41.8980358)"
"2015_CLARKE_REVS_SA","2015","20","CLARKE","4564963","2993","191935","4370035","960","45000","335520","2697593","11550","278520","27004","232750","7998932","623959","0","0","8622891","2557958","11180849","POINT (-93.78515790000002 41.0290323)"
"2021_MARION_REVS_SA","2021","63","MARION","14682853","0","774191","13908662","500","53000","1377246","8536807","46630","1353851","166100","217713","25660509","2772977","0","6000","28439486","11747218","40186704","POINT (-93.0994367 41.3344515)"
"2019_IDA_REVS_SA","2019","47","IDA","2649061","0","145000","2504061","100","20000","553417","3468549","5250","240725","27045","232853","7052000","1251361","0","0","8303361","3435536","11738897","POINT (-95.5134962 42.3868747)"
"2020_DUBUQUE_REVS_SA","2020","31","DUBUQUE","34099232","4181","1874697","32220354","4181","202250","4985103","11795346","111650","2413286","1405162","895787","54033119","7203969","0","0","61237088","31439726","92676814","POINT (-90.8824564 42.468832)"
"2013_JOHNSON_REVS_SA","2013","52","JOHNSON","43843198","0","654176","43189022","0","431000","836137","25126409","506985","3803230","158725","940262","74991770","22636534","5000000","212800","102841104","23384636","126225740","POINT (-91.5880849 41.6715511)"
"2015_RINGGOLD_REVS_SA","2015","80","RINGGOLD","2930242","0","70470","2859772","1000","25100","435354","3580549","4125","479376","15200","165330","7565806","726725","0","0","8292531","3472239","11764770","POINT (-94.2439719 40.7352023)"
"2018_CASS_REVS_SA","2018","15","CASS","7263339","0","423906","6839433","714","42370","1059381","6823671","32340","341990","150625","306135","15596659","3516992","0","0","19113651","6404789","25518440","POINT (-94.9278266 41.3314876)"
"2010_STORY_REVS_SA","2010","85","STORY","19991137","0","447903","19543234","4900","59800","2122071","9858176","22750","1623455","455822","217930","33908138","2000000","0","4505000","40413138","7895192","48308330","POINT (-93.4650448 42.0362415)"
"2013_LINN_REVS_SA","2013","57","LINN","57888269","183525","1267244","56437500","92700","822000","8245285","41490938","856944","7548324","793720","1297890","117585301","15610674","0","41150","133237125","21535141","154772266","POINT (-91.5989646 42.0789478)"
"2019_POCAHONTAS_REVS_SA","2019","76","POCAHONTAS","6842605","0","327530","6515075","300","11000","352376","4883059","19200","502029","169155","161000","12613194","1541996","0","1000","14156190","9304906","23461096","POINT (-94.67874660000001 42.73413510000001)"
"2021_WINNEBAGO_REVS_SA","2021","95","WINNEBAGO","7149621","0","0","7149621","145","12275","3636001","4167286","18200","1214739","396415","153850","16748532","2255502","750000","0","19754034","13076888","32830922","POINT (-93.7341955 43.37756780000001)"
"2022_WINNESHIEK_REVS_SA","2022","96","WINNESHIEK","10324522","200","612303","9712019","200","50350","1405266","9290786","40350","793920","174405","1706770","23174066","2795191","0","5000","25974257","8137634","34111891","POINT (-91.8437074 43.2906746)"
"2020_MAHASKA_REVS_SA","2020","62","MAHASKA","9684442","0","200706","9483736","0","42600","1395777","4579193","14800","664537","146717","923223","17250583","3668715","5000000","6000","25925298","7311215","33236513","POINT (-92.6409094 41.3352035)"
"2018_DICKINSON_REVS_SA","2018","30","DICKINSON","9615574","950","273400","9341224","950","43300","2248556","4905279","70700","665810","240315","337610","17853744","3512776","0","1000","21367520","10190216","31557736","POINT (-95.1508301 43.3779848)"
"2019_CASS_REVS_SA","2019","15","CASS","7355711","0","491973","6863738","1029","42370","1117739","8559625","21990","329200","171653","274060","17381404","4090043","0","0","21471447","9281529","30752976","POINT (-94.9278266 41.3314876)"
"2014_STORY_REVS_SA","2014","85","STORY","22841536","0","491337","22350199","2800","53000","2649736","9886237","39870","1987870","172220","592814","37734746","2307000","0","0","40041746","8787720","48829466","POINT (-93.4650448 42.0362415)"
"2016_BREMER_REVS_SA","2016","9","BREMER","8068569","0","437111","7631458","0","30000","1218845","5973984","277130","847800","216828","545825","16741870","3006735","0","15250","19763855","9554827","29318682","POINT (-92.31805480000001 42.7745873)"
"2019_WARREN_REVS_SA","2019","91","WARREN","14828075","0","678300","14149775","2600","115200","390537","7765753","92950","1431295","236746","586279","24771135","3425000","0","0","28196135","11007028","39203163","POINT (-93.5613594 41.3343735)"
"2017_PALO ALTO_REVS_SA","2017","74","PALO ALTO","6440268","0","313614","6126654","210","15600","1550131","4021211","9350","645831","60473","107650","12537110","2506136","0","0","15043246","9426973","24470219","POINT (-94.6781371 43.0820643)"
"2011_JACKSON_REVS_SA","2011","49","JACKSON","4976039","0","255754","4720285","333","50070","852190","5275704","31084","539790","285434","254944","12009834","1910701","0","5025","13925560","4037998","17963558","POINT (-90.5742294 42.1717426)"
"2021_SAC_REVS_SA","2021","81","SAC","6325782","0","453130","5872652","730","20750","605940","5480799","16500","1156364","59082","103500","13316317","1679750","0","11500","15007567","4868560","19876127","POINT (-95.1053946 42.3862604)"
"2014_ADAMS_REVS_SA","2014","2","ADAMS","2414649","226","105907","2308516","444","5100","741000","2617147","10200","386850","105268","12545","6187070","860325","0","0","7047395","3023605","10071000","POINT (-94.6991849 41.02898390000001)"
"2016_WEBSTER_REVS_SA","2016","94","WEBSTER","12160748","0","834293","11326455","5000","109500","3988772","11228712","51500","982655","154350","478073","28325017","6719041","3000000","98608","38142666","11345469","49488135","POINT (-94.18178810000002 42.4279662)"
"2012_SHELBY_REVS_SA","2012","83","SHELBY","5075073","0","262900","4812173","0","22000","750061","5060776","222984","265580","92020","115733","11341327","2533637","0","2000","13876964","3411436","17288400","POINT (-95.31021130000002 41.6850926)"
"2022_DELAWARE_REVS_SA","2022","28","DELAWARE","11005260","4500","591823","10408937","335","30200","1311781","6376699","41250","525285","159210","136364","18990061","2984599","0","0","21974660","12951330","34925990","POINT (-91.3673502 42.471211)"
"2010_MAHASKA_REVS_SA","2010","62","MAHASKA","6830796","0","127382","6703414","1900","9700","1575900","4726550","24600","533885","556919","347400","14480268","1646197","0","0","16126465","9418923","25545388","POINT (-92.6409094 41.3352035)"
"2016_HANCOCK_REVS_SA","2016","41","HANCOCK","5280949","0","147000","5133949","1400","30000","508448","3934480","17275","359873","207606","260750","10453781","2170000","0","0","12623781","4498642","17122423","POINT (-93.7342723 43.0818861)"
"2018_TAMA_REVS_SA","2018","86","TAMA","9063462","5458","600384","8457620","709","56952","1053938","7295667","19450","541419","80461","958442","18464658","2455465","0","111500","21031623","8900676","29932299","POINT (-92.5325425 42.07981170000001)"
"2016_WRIGHT_REVS_SA","2016","99","WRIGHT","6666099","310","396045","6269744","585","41201","845654","6706955","14025","609100","203314","148584","14839162","1818075","0","1000","16658237","5184049","21842286","POINT (-93.7351465 42.7331189)"
"2017_HARDIN_REVS_SA","2017","42","HARDIN","7732245","0","398530","7333715","2040","0","1488086","5736068","2000","463405","136675","1481803","16643792","1910547","0","0","18554339","7190327","25744666","POINT (-93.2404025 42.3838803)"
"2012_CRAWFORD_REVS_SA","2012","24","CRAWFORD","6971780","48550","256450","6666780","1700","47000","809246","6782055","4500","648297","132366","126150","15218094","2082500","0","26500","17327094","6398606","23725700","POINT (-95.3819678 42.0372125)"
"2012_WINNESHIEK_REVS_SA","2012","96","WINNESHIEK","7591844","1200","274756","7315888","700","25650","1369760","6253944","12900","651240","184955","725366","16540403","1909146","0","255021","18704570","3919758","22624328","POINT (-91.8437074 43.2906746)"
"2019_MITCHELL_REVS_SA","2019","66","MITCHELL","5526863","0","279660","5247203","0","20000","4375366","4949467","6000","576435","227700","65636","15467807","1396180","0","1000","16864987","5319089","22184076","POINT (-92.7890315 43.3564124)"
"2018_PLYMOUTH_REVS_SA","2018","75","PLYMOUTH","9879401","1000","533815","9344586","1500","62400","1833512","7843886","32750","1063485","168430","167140","20517689","4305100","0","0","24822789","6794673","31617462","POINT (-96.2140431 42.7378346)"
"2020_SHELBY_REVS_SA","2020","83","SHELBY","6542440","0","285364","6257076","200","29000","775652","4339240","170447","307220","74022","123800","12076657","3334210","0","0","15410867","4324264","19735131","POINT (-95.31021130000002 41.6850926)"
"2014_LOUISA_REVS_SA","2014","58","LOUISA","4958521","14550","148547","4795424","7250","41000","1136748","10572489","16739","441485","32500","73300","17116935","1433664","0","0","18550599","3685748","22236347","POINT (-91.2596184 41.2185073)"
"2021_DUBUQUE_REVS_SA","2021","31","DUBUQUE","34789975","2920","1712465","33074590","2920","156000","5535707","9947263","108650","2520450","1141341","1084879","53571800","5878042","0","0","59449842","32542421","91992263","POINT (-90.8824564 42.468832)"
"2011_FLOYD_REVS_SA","2011","34","FLOYD","5457453","0","275177","5182276","0","10100","788440","4401128","16000","454230","160975","151573","11164722","919000","0","0","12083722","13532429","25616151","POINT (-92.78900330000002 43.0599208)"
"2017_SCOTT_REVS_SA","2017","82","SCOTT","47737932","27703","2046454","45663775","27703","780000","6941122","13720825","630330","5469719","283379","795000","74311853","13042109","0","150000","87503962","35025825","122529787","POINT (-90.6232428 41.6370978)"
"2014_ADAIR_REVS_SA","2014","1","ADAIR","4283442","1637","189368","4092437","1170","27000","1608622","3363614","17800","178495","35229","44355","9368722","1621247","0","5000","10994969","3817487","14812456","POINT (-94.4709413 41.3307464)"
"2010_WAPELLO_REVS_SA","2010","90","WAPELLO","9060197","15324","537190","8507683","5623","141000","2359098","6411957","62750","788294","317118","248183","18841706","1000000","0","3000","19844706","7108061","26952767","POINT (-92.4094499 41.03058450000001)"
"2011_FRANKLIN_REVS_SA","2011","35","FRANKLIN","5537419","1500","20","5535899","900","10300","573636","6204910","11300","612669","151800","104675","13206089","1629046","0","5000","14840135","21152264","35992399","POINT (-93.262473 42.7325458)"
"2016_MONONA_REVS_SA","2016","67","MONONA","5817169","654","247500","5569015","2350","23600","521696","5732136","8100","218925","199606","131590","12407018","1551110","0","0","13958128","5390369","19348497","POINT (-95.9599235 42.0516663)"
"2020_BREMER_REVS_SA","2020","9","BREMER","8118327","0","416304","7702023","75","50597","1237303","6472856","305968","1006100","418724","340940","17534586","3423098","30275","1300","20989259","14815632","35804891","POINT (-92.31805480000001 42.7745873)"
"2014_CEDAR_REVS_SA","2014","16","CEDAR","7264913","4000","280100","6980813","3200","46500","897884","5171033","27850","987409","179945","65570","14360204","1966595","25000","8401","16360200","3998992","20359192","POINT (-91.1324125 41.7723207)"
"2019_WORTH_REVS_SA","2019","98","WORTH","4647896","25452","331328","4291116","10","18725","4483512","4228005","27622","291467","63831","1950634","15354922","1183884","0","1301","16540107","7787204","24327311","POINT (-93.2608476 43.3773984)"
"2011_CHEROKEE_REVS_SA","2011","18","CHEROKEE","4376190","0","205292","4170898","75","3300","929564","4183453","52535","270100","112670","67950","9790545","1425000","0","10000","11225545","4771234","15996779","POINT (-95.6238055 42.7356226)"
"2012_HUMBOLDT_REVS_SA","2012","46","HUMBOLDT","4675423","0","195452","4479971","1401","5650","551964","3192446","4600","235950","73400","169351","8714733","1363697","0","1000","10079430","4440941","14520371","POINT (-94.2071868 42.7764686)"
"2014_FAYETTE_REVS_SA","2014","33","FAYETTE","7463560","2900","350004","7110656","5500","57410","797205","5190085","19200","662950","45790","483422","14372218","1801761","0","0","16173979","3435558","19609537","POINT (-91.8443207 42.8625919)"
"2022_CARROLL_REVS_SA","2022","14","CARROLL","8835971","0","550000","8285971","0","12000","1474451","5500706","47200","2082003","265875","466780","18134986","3210870","0","0","21345856","6324753","27670609","POINT (-94.8605593 42.0362382)"
"2010_ADAMS_REVS_SA","2010","2","ADAMS","2510702","0","107527","2403175","213","12600","697968","3095544","9400","279825","140494","18930","6658149","636606","0","0","7294755","1827152","9121907","POINT (-94.6991849 41.02898390000001)"
"2021_CEDAR_REVS_SA","2021","16","CEDAR","9993720","0","520131","9473589","400","42200","1036399","6487767","37419","1225194","109190","112440","18524598","2920448","65000","1000","21511046","7125628","28636674","POINT (-91.1324125 41.7723207)"
"2022_KOSSUTH_REVS_SA","2022","55","KOSSUTH","9483629","0","518792","8964837","1700","22500","1735142","7539873","26150","631750","177552","126250","19225754","2975572","32250","15000","22248576","10548553","32797129","POINT (-94.2067199 43.20413)"
"2012_MONROE_REVS_SA","2012","68","MONROE","4285818","0","104150","4181668","575","3000","607503","3254855","2500","161670","58410","16425","8286606","949712","0","12000","9248318","2565667","11813985","POINT (-92.8689877 41.0297826)"
"2018_LOUISA_REVS_SA","2018","58","LOUISA","5156507","4343","452073","4700091","3500","49095","1236067","3726475","25273","573261","26716","36438","10376916","1882500","0","53200","12312616","6368328","18680944","POINT (-91.2596184 41.2185073)"
"2015_CALHOUN_REVS_SA","2015","13","CALHOUN","6269090","0","274500","5994590","1100","25000","534165","4382654","17550","868950","121000","128850","12073859","1376970","0","500","13451329","9827840","23279169","POINT (-94.6404136 42.385184800000005)"
"2015_FAYETTE_REVS_SA","2015","33","FAYETTE","7598234","2900","404019","7191315","5000","59210","809106","5660013","20800","811490","66950","455424","15079308","1835308","0","0","16914616","3638724","20553340","POINT (-91.8443207 42.8625919)"
"2013_CEDAR_REVS_SA","2013","16","CEDAR","7021494","5000","228350","6788144","3850","46500","803723","5379249","42200","962832","180942","65850","14273290","1866701","30000","8401","16178392","4400596","20578988","POINT (-91.1324125 41.7723207)"
"2010_PLYMOUTH_REVS_SA","2010","75","PLYMOUTH","6823320","3600","289375","6530345","3050","38700","1927339","7889150","19550","1029900","289600","317000","18044634","3018799","99000","0","21162433","2154076","23316509","POINT (-96.2140431 42.7378346)"
"2012_BREMER_REVS_SA","2012","9","BREMER","6542129","0","199677","6342452","0","14000","1179129","5041688","289050","768170","332600","293790","14260879","2763750","12000","0","17036629","11173747","28210376","POINT (-92.31805480000001 42.7745873)"
"2013_BUENA VISTA_REVS_SA","2013","11","BUENA VISTA","8350685","41754","248970","8059961","2823","46950","1044379","5001327","45851","667240","120698","29795","15019024","2208423","0","700","17228147","6918678","24146825","POINT (-95.15114900000002 42.7354936)"
"2020_STORY_REVS_SA","2020","85","STORY","28205681","0","1030109","27175572","3050","75000","3445064","8669030","69420","1841405","511405","665920","42455866","3500000","0","6000","45961866","18898517","64860383","POINT (-93.4650448 42.0362415)"
"2012_WINNEBAGO_REVS_SA","2012","95","WINNEBAGO","4420333","737","188190","4231406","2293","27600","559778","3999920","15684","1086061","281958","127981","10332681","1453223","218754","0","12004658","8858093","20862751","POINT (-93.7341955 43.37756780000001)"
"2022_CHICKASAW_REVS_SA","2022","19","CHICKASAW","6670489","29820","308350","6332319","500","15000","923188","4918315","34000","712661","58914","153800","13148697","1747140","0","0","14895837","6178876","21074713","POINT (-92.3176637 43.06004140000001)"
"2012_FREMONT_REVS_SA","2012","36","FREMONT","3665628","0","148467","3517161","1650","24045","1195084","3671173","20055","293732","143754","177462","9044116","908000","146693","24000","10122809","3706830","13829639","POINT (-95.6046765 40.7455892)"
"2014_LINN_REVS_SA","2014","57","LINN","59935630","188209","1552037","58195384","48000","812216","7745759","31383156","960930","7411385","609322","1343522","108509674","16937491","0","35150","125482315","23706820","149189135","POINT (-91.5989646 42.0789478)"
"2010_BLACK HAWK_REVS_SA","2010","7","BLACK HAWK","29056777","37590","975503","28043684","20000","386000","3953367","38574194","450711","5657972","1401524","1382236","79869688","2083911","0","0","81953599","23186290","105139889","POINT (-92.3088197 42.4700957)"
"2019_DICKINSON_REVS_SA","2019","30","DICKINSON","9692218","900","264245","9427073","900","42400","1836075","4800239","73600","674095","181551","545885","17581818","3570774","0","1000","21153592","10343053","31496645","POINT (-95.1508301 43.3779848)"
"2012_JEFFERSON_REVS_SA","2012","51","JEFFERSON","5406666","1750","174000","5230916","1230","62200","657677","3494183","13914","499858","140226","116185","10216389","1000000","0","0","11216389","3104104","14320493","POINT (-91.9488774 41.0317596)"
"2010_MADISON_REVS_SA","2010","61","MADISON","4404995","0","158247","4246748","0","56664","902707","5292896","45100","760800","156568","56054","11517537","1335534","0","2000","12855071","2973972","15829043","POINT (-94.01556190000001 41.33071420000001)"
"2013_SIOUX_REVS_SA","2013","84","SIOUX","8029983","0","251640","7778343","710","20550","1885853","12162038","15450","710390","122674","564860","23260868","3015550","0","5000","26281418","5274383","31555801","POINT (-96.1778827 43.0826174)"
"2011_CHICKASAW_REVS_SA","2011","19","CHICKASAW","4038729","2335","139142","3897252","325","3000","664795","4677885","6450","478481","94195","93000","9915383","1957788","0","500","11873671","5759830","17633501","POINT (-92.3176637 43.06004140000001)"
"2015_CHEROKEE_REVS_SA","2015","18","CHEROKEE","5583413","0","269425","5313988","0","24225","1000925","4991990","44676","293300","51220","145150","11865474","1783500","0","2000","13650974","6563362","20214336","POINT (-95.6238055 42.7356226)"
"2019_JOHNSON_REVS_SA","2019","52","JOHNSON","60183984","0","1923254","58260730","0","329000","754755","20640600","685850","4958120","362335","1917073","87908463","15323711","19732000","209000","123173174","27984059","151157233","POINT (-91.5880849 41.6715511)"
"2014_HENRY_REVS_SA","2014","44","HENRY","7302569","0","263546","7039023","3467","53300","889428","3479476","60200","562250","53308","60750","12201202","1157107","0","0","13358309","7091235","20449544","POINT (-91.5445241 40.9879383)"
"2016_STORY_REVS_SA","2016","85","STORY","24753948","0","752905","24001043","1000","50000","3178678","9070853","63230","1807426","569910","1074970","39817110","3775000","108024","1500","43701634","12323032","56024666","POINT (-93.4650448 42.0362415)"
"2012_PAGE_REVS_SA","2012","73","PAGE","4092834","10000","191906","3890928","2200","31200","548806","4579339","45015","371114","79274","291762","9839638","1016089","0","50000","10905727","4054493","14960220","POINT (-95.1501747 40.7391444)"
"2015_FRANKLIN_REVS_SA","2015","35","FRANKLIN","6301427","1250","255384","6044793","756","15525","1963213","5299839","12800","657524","82758","102935","14180143","1660990","0","9000","15850133","6252854","22102987","POINT (-93.262473 42.7325458)"
"2016_MONROE_REVS_SA","2016","68","MONROE","4749615","0","94250","4655365","645","5500","623980","4154513","2500","159875","53404","21265","9677047","1535807","5700000","5000","16917854","4513441","21431295","POINT (-92.8689877 41.0297826)"
"2015_JOHNSON_REVS_SA","2015","52","JOHNSON","48999441","0","1242396","47757045","715","358000","868086","19431888","570925","4123676","222279","2459793","75792407","14103015","14000000","8300","103903722","26031259","129934981","POINT (-91.5880849 41.6715511)"
"2018_ADAMS_REVS_SA","2018","2","ADAMS","3453222","226","113837","3339159","4","0","840603","3048627","4638","429015","51639","17245","7730930","981477","0","0","8712407","3150347","11862754","POINT (-94.6991849 41.02898390000001)"
"2019_FRANKLIN_REVS_SA","2019","35","FRANKLIN","6562313","1000","374623","6186690","1000","31200","4253690","5123377","24550","576784","63175","106025","16366491","2463531","0","91000","18921022","16991533","35912555","POINT (-93.262473 42.7325458)"
"2010_TAMA_REVS_SA","2010","86","TAMA","7207289","7524","386110","6813655","4131","73005","937535","6193871","0","371508","122430","483399","14999534","1788319","0","4000","16791853","3490780","20282633","POINT (-92.5325425 42.07981170000001)"
"2012_APPANOOSE_REVS_SA","2012","4","APPANOOSE","3910331","0","188491","3721840","2200","5500","1022303","4569232","500","275251","50050","135854","9782730","776553","142805","0","10702088","6347799","17049887","POINT (-92.8686104 40.7431635)"
"2022_BUTLER_REVS_SA","2022","12","BUTLER","7538037","0","447350","7090687","650","20700","1579195","5495061","44000","528449","280921","491865","15531528","4055000","0","0","19586528","6044871","25631399","POINT (-92.7901934 42.7315661)"
"2021_MILLS_REVS_SA","2021","65","MILLS","10491724","0","443533","10048191","0","55848","1652565","9555200","319925","427931","95150","210608","22365418","3037122","0","0","25402540","10695708","36098248","POINT (-95.62132670000001 41.0334523)"
"2017_MONTGOMERY_REVS_SA","2017","69","MONTGOMERY","5688129","3500","341655","5342974","2440","50665","598621","4181223","7400","275269","45561","59994","10564147","867000","0","0","11431147","5185507","16616654","POINT (-95.1563758 41.03014)"
"2018_CHICKASAW_REVS_SA","2018","19","CHICKASAW","5602776","1217","323325","5278234","447","25000","831307","5265091","7400","591531","87541","74800","12161351","2143453","0","1000","14305804","6395643","20701447","POINT (-92.3176637 43.06004140000001)"
"2013_STORY_REVS_SA","2013","85","STORY","21789107","0","407646","21381461","4200","55000","2537436","12276824","36750","1771650","177850","463270","38704441","2095000","0","0","40799441","8255462","49054903","POINT (-93.4650448 42.0362415)"
"2012_CLINTON_REVS_SA","2012","23","CLINTON","16871103","0","533580","16337523","11735","134000","2481790","11003916","91670","980180","281420","246744","31568978","2210686","0","0","33779664","10000730","43780394","POINT (-90.5319724 41.8980358)"
"2013_MUSCATINE_REVS_SA","2013","70","MUSCATINE","15023025","0","379400","14643625","10100","142000","2052046","11971530","55700","928713","446705","161680","30412099","2124000","3750000","11000","36297099","6723000","43020099","POINT (-91.1127562 41.4839221)"
"2015_HAMILTON_REVS_SA","2015","40","HAMILTON","7421818","5000","301714","7115104","1500","26500","1110164","5040987","18475","1441310","222961","1966660","16943661","3003267","0","6600","19953528","18038851","37992379","POINT (-93.7068085 42.3837722)"
"2011_APPANOOSE_REVS_SA","2011","4","APPANOOSE","3688336","0","263331","3425005","1800","5500","1361806","4456406","500","269061","50100","21450","9591628","499940","140325","0","10231893","5974566","16206459","POINT (-92.8686104 40.7431635)"
"2020_POTTAWATTAMIE_REVS_SA","2020","78","POTTAWATTAMIE","44626983","0","1712400","42914583","3000","317000","8149222","19517144","279300","2516578","493070","4164600","78354497","7525000","0","0","85879497","42482554","128362051","POINT (-95.5423935 41.3366123)"
"2017_CLAYTON_REVS_SA","2017","22","CLAYTON","8686445","0","531728","8154717","1285","51300","1314792","5545692","33950","448145","165101","164710","15879692","1700000","0","11000","17590692","5832146","23422838","POINT (-91.34143280000002 42.8447493)"
"2020_LOUISA_REVS_SA","2020","58","LOUISA","5799954","4843","313296","5481815","2500","25500","1221567","3770346","29437","555425","47740","124610","11258940","1597430","0","0","12856370","4023986","16880356","POINT (-91.2596184 41.2185073)"
"2018_BLACK HAWK_REVS_SA","2018","7","BLACK HAWK","36397057","47370","1708000","34641687","3700","331500","4601513","14810185","537900","4323389","651867","2246695","62148436","8746584","0","5200","70900220","33330024","104230244","POINT (-92.3088197 42.4700957)"
"2020_MONROE_REVS_SA","2020","68","MONROE","5409925","0","258471","5151454","800","4100","388134","3745727","3000","164735","63503","100905","9622358","1537288","1100000","5000","12264646","5250438","17515084","POINT (-92.8689877 41.0297826)"
"2021_PLYMOUTH_REVS_SA","2021","75","PLYMOUTH","11485494","1000","502257","10982237","1000","54000","1877076","8687352","38625","1332675","288825","280550","23542340","4675000","0","0","28217340","7827930","36045270","POINT (-96.2140431 42.7378346)"
"2022_TAYLOR_REVS_SA","2022","87","TAYLOR","4784729","3230","258692","4522807","715","0","295450","5047385","7450","403010","52260","74160","10403237","957672","0","0","11360909","4925327","16286236","POINT (-94.6964148 40.73743240000001)"
"2013_GRUNDY_REVS_SA","2013","38","GRUNDY","5208278","0","203500","5004778","0","0","594828","5093605","6450","252898","72520","141154","11166233","1577600","0","0","12743833","4748296","17492129","POINT (-92.7914177 42.4018651)"
"2019_CLARKE_REVS_SA","2019","20","CLARKE","4815308","2993","220358","4591957","960","45000","305814","3332461","35050","304145","36254","239650","8891291","787904","0","0","9679195","4769858","14449053","POINT (-93.78515790000002 41.0290323)"
"2019_MONONA_REVS_SA","2019","67","MONONA","6144190","737","260130","5883323","400","16120","486095","5241269","7100","253275","178194","335118","12400894","1697769","0","155000","14253663","7175853","21429516","POINT (-95.9599235 42.0516663)"
"2022_FREMONT_REVS_SA","2022","36","FREMONT","5913620","1770","304510","5607340","1160","24045","620281","10229470","19900","313045","103251","145892","17064384","1391261","104648","95000","18655293","4666589","23321882","POINT (-95.6046765 40.7455892)"
"2019_APPANOOSE_REVS_SA","2019","4","APPANOOSE","4459422","0","355618","4103804","0","6000","1073411","4296689","3150","314779","25000","54213","9877046","665110","103283","0","10645439","7097671","17743110","POINT (-92.8686104 40.7431635)"
"2017_KEOKUK_REVS_SA","2017","54","KEOKUK","4799939","40000","170700","4589239","1200","41000","463127","4805190","45000","584915","149814","136200","10815685","1714500","0","0","12530185","4452494","16982679","POINT (-92.1786426 41.336465)"
"2021_ALLAMAKEE_REVS_SA","2021","3","ALLAMAKEE","7818077","0","478128","7339949","0","0","1022991","5024810","20564","325735","119555","139384","13992988","2061960","7000","0","16061948","4904539","20966487","POINT (-91.3780923 43.2842838)"
"2018_FLOYD_REVS_SA","2018","34","FLOYD","6093211","0","343594","5749617","0","13300","1559020","5993777","28000","466820","120570","373497","14304601","1305687","0","0","15610288","14180873","29791161","POINT (-92.78900330000002 43.0599208)"
"2020_EMMET_REVS_SA","2020","32","EMMET","5029967","75","308520","4721372","275","8100","420174","3155311","16500","338482","83080","236735","8980029","1052789","0","0","10032818","6082850","16115668","POINT (-94.6784803 43.37802250000001)"
"2017_TAMA_REVS_SA","2017","86","TAMA","9063465","0","523609","8539856","726","56906","967095","7348159","12674","558941","60668","116214","17661239","2150000","0","3500","19814739","6885357","26700096","POINT (-92.5325425 42.07981170000001)"
"2020_JONES_REVS_SA","2020","53","JONES","8470082","1000","541230","7927852","720","42050","1024311","6345429","68836","602953","231674","572948","16816773","2463664","448000","8000","19736437","8912552","28648989","POINT (-91.1314352 42.1212397)"
"2019_MAHASKA_REVS_SA","2019","62","MAHASKA","8474893","0","320697","8154196","0","40900","1350690","4987284","14600","656987","146010","336750","15687417","2440155","0","6000","18133572","8994161","27127733","POINT (-92.6409094 41.3352035)"
"2022_MONROE_REVS_SA","2022","68","MONROE","5378309","0","258808","5119501","0","2750","569631","3797423","3000","146465","43165","55380","9737315","1487102","0","5000","11229417","5924754","17154171","POINT (-92.8689877 41.0297826)"
"2013_BENTON_REVS_SA","2013","6","BENTON","8422474","0","331404","8091070","2500","63000","1054311","7865619","24150","896410","148710","277500","18423270","3267584","43774","41000","21775628","9071784","30847412","POINT (-92.0656912 42.0801864)"
"2012_MARION_REVS_SA","2012","63","MARION","9926916","0","322502","9604414","500","53000","1321647","6429710","36160","1116011","209928","524522","19295892","2037240","0","1000","21334132","10839371","32173503","POINT (-93.0994367 41.3344515)"
"2021_FRANKLIN_REVS_SA","2021","35","FRANKLIN","8112792","1250","402409","7709133","1000","31100","3731064","5467354","22750","508800","131790","90745","17693736","3685479","0","25000","21404215","10596740","32000955","POINT (-93.262473 42.7325458)"
"2018_O'BRIEN_REVS_SA","2018","71","O'BRIEN","6799042","0","429750","6369292","128","33500","740430","5503650","94500","513375","188397","158350","13601622","2060650","0","0","15662272","7510062","23172334","POINT (-95.6248784 43.0837527)"
"2013_JONES_REVS_SA","2013","53","JONES","6977068","1030","297428","6678610","575","41200","965936","6347973","73109","536560","174173","294894","15113030","1583000","0","0","16696030","3806886","20502916","POINT (-91.1314352 42.1212397)"
"2021_TAMA_REVS_SA","2021","86","TAMA","9772526","0","0","9772526","1615","24652","1934458","10713671","21850","595230","149700","240193","23453895","3138965","0","9000","26601860","7940073","34541933","POINT (-92.5325425 42.07981170000001)"
"2010_DES MOINES_REVS_SA","2010","29","DES MOINES","11580720","12048","255550","11313122","6435","129900","2541186","9638881","41140","899015","269518","366836","25206033","1708524","0","0","26914557","4166851","31081408","POINT (-91.1814707 40.9231829)"
"2010_GUTHRIE_REVS_SA","2010","39","GUTHRIE","3027020","0","138500","2888520","4150","36200","960121","4855196","26500","371261","271510","439219","9852677","1459225","0","650","11312552","5115221","16427773","POINT (-94.501055 41.6837548)"
"2022_DICKINSON_REVS_SA","2022","30","DICKINSON","11855185","1300","321425","11532460","1300","37200","1942090","8919626","76100","847025","143283","525652","24024736","5030815","0","500","29056051","12041883","41097934","POINT (-95.1508301 43.3779848)"
"2016_AUDUBON_REVS_SA","2016","5","AUDUBON","3616467","0","220030","3396437","0","0","415795","3433192","10000","212028","17110","23050","7507612","857860","360000","0","8725472","4240355","12965827","POINT (-94.9058222 41.6845893)"
"2011_MAHASKA_REVS_SA","2011","62","MAHASKA","7059674","0","127382","6932292","1900","9700","1444886","4762460","23950","547600","568394","355850","14647032","1696285","0","0","16343317","8848350","25191667","POINT (-92.6409094 41.3352035)"
"2018_DES MOINES_REVS_SA","2018","29","DES MOINES","13147027","16615","824134","12306278","7447","120000","2709819","7297925","41315","928449","443348","319940","24174521","2709551","2924593","0","29808665","11717972","41526637","POINT (-91.1814707 40.9231829)"
"2015_MONONA_REVS_SA","2015","67","MONONA","5650905","5615","245600","5399690","2360","23600","513619","4578337","9050","251255","244345","154600","11176856","1624461","0","0","12801317","4552169","17353486","POINT (-95.9599235 42.0516663)"
"2013_WINNESHIEK_REVS_SA","2013","96","WINNESHIEK","7951875","1200","276489","7674186","375","25380","1369052","7549896","12750","660390","171825","668701","18132555","2038060","0","25000","20195615","5058411","25254026","POINT (-91.8437074 43.2906746)"
"2013_ADAIR_REVS_SA","2013","1","ADAIR","4090412","3559","155773","3931080","1420","27000","1367336","3579490","21300","177665","60719","48655","9214665","1906959","0","0","11121624","4889841","16011465","POINT (-94.4709413 41.3307464)"
"2010_O'BRIEN_REVS_SA","2010","71","O'BRIEN","5212170","0","220728","4991442","590","12550","650527","4916317","77250","349315","172132","76125","11246248","1230278","0","0","12476526","3087193","15563719","POINT (-95.6248784 43.0837527)"
"2014_DES MOINES_REVS_SA","2014","29","DES MOINES","12963392","16217","423336","12523839","5900","131800","2506544","5650321","49875","1007842","122305","357400","22355826","3296167","1500000","0","27151993","5570715","32722708","POINT (-91.1814707 40.9231829)"
"2011_WEBSTER_REVS_SA","2011","94","WEBSTER","11590959","0","352812","11238147","9780","115000","2588590","10455602","29000","1035160","345850","69533","25886662","2080000","0","0","27966662","6373737","34340399","POINT (-94.18178810000002 42.4279662)"
"2014_BUTLER_REVS_SA","2014","12","BUTLER","6059883","0","199400","5860483","0","8000","714658","23663670","15600","506330","432289","391525","31592555","2287500","0","0","33880055","12646366","46526421","POINT (-92.7901934 42.7315661)"
"2017_ADAIR_REVS_SA","2017","1","ADAIR","4768664","0","267639","4501025","0","27000","2794996","4552101","14200","173740","38440","34020","12135522","1572406","0","10000","13717928","9969820","23687748","POINT (-94.4709413 41.3307464)"
"2016_GREENE_REVS_SA","2016","37","GREENE","4923298","0","291650","4631648","0","15000","685633","4095041","65975","373400","56306","796200","10719203","1255000","0","15000","11989203","3979866","15969069","POINT (-94.3968356 42.0362394)"
"2014_FLOYD_REVS_SA","2014","34","FLOYD","5805144","0","290367","5514777","0","25200","1212382","4471698","25000","449060","89155","352520","12139792","1496733","0","0","13636525","8159473","21795998","POINT (-92.78900330000002 43.0599208)"
"2012_POTTAWATTAMIE_REVS_SA","2012","78","POTTAWATTAMIE","32463655","0","676700","31786955","13500","304500","8214755","18158740","322650","2515255","317256","2811452","64445063","7064851","0","0","71509914","24608915","96118829","POINT (-95.5423935 41.3366123)"
"2017_WINNESHIEK_REVS_SA","2017","96","WINNESHIEK","9207578","220","567583","8639775","220","25250","1512466","9559586","22750","680550","134680","1902441","22477718","2596619","0","1030000","26104337","5494806","31599143","POINT (-91.8437074 43.2906746)"
"2010_CLAYTON_REVS_SA","2010","22","CLAYTON","7224872","0","351006","6873866","1120","54465","1249775","5335086","18675","408370","363919","238208","14543484","1400000","0","101700","16045184","5352999","21398183","POINT (-91.34143280000002 42.8447493)"
"2011_GUTHRIE_REVS_SA","2011","39","GUTHRIE","3722332","0","132500","3589832","3850","36200","991267","5050457","22600","471558","257635","410894","10834293","1397972","0","250","12232515","2932648","15165163","POINT (-94.501055 41.6837548)"
"2011_MONONA_REVS_SA","2011","67","MONONA","4902837","1345","229350","4672142","4400","24200","409772","4946676","11500","224060","144660","77770","10515180","1119298","0","0","11634478","5076211","16710689","POINT (-95.9599235 42.0516663)"
"2018_CRAWFORD_REVS_SA","2018","24","CRAWFORD","8765435","7735","415500","8342200","1550","47500","789351","7034540","10000","980998","135828","184170","17526137","3219500","0","181500","20927137","7244089","28171226","POINT (-95.3819678 42.0372125)"
"2017_GREENE_REVS_SA","2017","37","GREENE","4974126","0","307225","4666901","0","20000","730711","4398139","71550","384300","56286","632103","10959990","1862000","0","20000","12841990","4203978","17045968","POINT (-94.3968356 42.0362394)"
"2010_FLOYD_REVS_SA","2010","34","FLOYD","5253580","0","275428","4978152","0","10500","807844","5745036","19050","455280","321600","162864","12500326","986712","0","0","13487038","7547153","21034191","POINT (-92.78900330000002 43.0599208)"
"2022_JEFFERSON_REVS_SA","2022","51","JEFFERSON","7750898","5700","403297","7341901","1210","56400","889658","4129909","39700","3080300","89000","65914","15693992","1100000","0","0","16793992","4209801","21003793","POINT (-91.9488774 41.0317596)"
"2010_WAYNE_REVS_SA","2010","93","WAYNE","2297073","8171","129440","2159462","4720","29800","895950","3718400","12430","275310","147670","122556","7366298","490644","0","0","7856942","2262877","10119819","POINT (-93.3273639 40.73947020000001)"
"2019_DAVIS_REVS_SA","2019","26","DAVIS","4538485","0","304923","4233562","687","24723","619584","4301009","1218","212874","173596","514105","10081358","914086","0","0","10995444","2465731","13461175","POINT (-92.4097173 40.7476891)"
"2014_OSCEOLA_REVS_SA","2014","72","OSCEOLA","3637680","0","186985","3450695","16559","0","601415","2592527","18250","275184","54380","38840","7047850","1285801","0","0","8333651","2597696","10931347","POINT (-95.6236852 43.3785704)"
"2012_EMMET_REVS_SA","2012","32","EMMET","4381540","250","143800","4237490","650","15800","333523","3030080","11200","294297","62193","124111","8109344","840066","0","1200","8950610","2104409","11055019","POINT (-94.6784803 43.37802250000001)"
"2018_LEE_REVS_SA","2018","56","LEE","11014438","0","897787","10116651","13648","142000","2436118","9426421","244400","1039267","229347","264770","23912622","1778947","0","100","25691669","12187789","37879458","POINT (-91.479264 40.6419764)"
"2015_OSCEOLA_REVS_SA","2015","72","OSCEOLA","3896838","0","201790","3695048","112","0","645040","2506442","20950","277229","53080","58640","7256541","922140","0","0","8178681","3053131","11231812","POINT (-95.6236852 43.3785704)"
"2014_VAN BUREN_REVS_SA","2014","89","VAN BUREN","2649738","850","131800","2517088","850","37000","303457","3557069","12900","255870","112400","42650","6839284","666428","0","2350","7508062","1988355","9496417","POINT (-91.9499871 40.7532294)"
"2020_HARRISON_REVS_SA","2020","43","HARRISON","8226480","2300","440625","7783555","1150","53000","685121","5381839","36050","661435","126295","350215","15078660","2324600","0","0","17403260","10938235","28341495","POINT (-95.8169209 41.6828528)"
"2012_KOSSUTH_REVS_SA","2012","55","KOSSUTH","8068728","0","363878","7704850","0","30300","934140","6378243","16050","967750","244634","96910","16372877","2868900","0","10000","19251777","7667824","26919601","POINT (-94.2067199 43.20413)"
"2011_WRIGHT_REVS_SA","2011","99","WRIGHT","5813901","600","233699","5579602","145","25530","514486","6678655","9550","515495","174862","203000","13701325","1552481","0","1000","15254806","4534785","19789591","POINT (-93.7351465 42.7331189)"
"2013_MILLS_REVS_SA","2013","65","MILLS","7111866","0","232523","6879343","0","62200","1111424","5642564","116150","419645","113288","131178","14475792","1954607","80000","7000","16517399","5581527","22098926","POINT (-95.62132670000001 41.0334523)"
"2010_MITCHELL_REVS_SA","2010","66","MITCHELL","4215944","0","213220","4002724","0","18300","563362","4721334","9500","1189513","312074","20700","10837507","1301160","9010000","0","21148667","2279730","23428397","POINT (-92.7890315 43.3564124)"
"2016_EMMET_REVS_SA","2016","32","EMMET","4488871","250","251095","4237526","250","21150","427946","3020778","13500","312802","20846","168615","8223413","985013","0","0","9208426","4096521","13304947","POINT (-94.6784803 43.37802250000001)"
"2018_UNION_REVS_SA","2018","88","UNION","5258259","0","246740","5011519","1590","52200","826825","6112295","27550","427149","39250","117100","12615478","1131123","0","0","13746601","3054929","16801530","POINT (-94.2423792 41.0277304)"
"2018_MADISON_REVS_SA","2018","61","MADISON","6609635","0","294603","6315032","33","67255","1178430","5386152","56280","964490","97513","59073","14124258","1855246","400000","2000","16381504","3752683","20134187","POINT (-94.01556190000001 41.33071420000001)"
"2014_HAMILTON_REVS_SA","2014","40","HAMILTON","7441712","5000","318337","7118375","1900","26500","1044583","5787356","18475","1250171","99201","1952404","17298965","2770022","0","8000","20076987","3972510","24049497","POINT (-93.7068085 42.3837722)"
"2010_WORTH_REVS_SA","2010","98","WORTH","3477242","579","189769","3286894","183","22588","1691825","3100690","12178","279859","309585","478661","9182463","868013","6000000","1267","16051743","3873433","19925176","POINT (-93.2608476 43.3773984)"
"2013_FAYETTE_REVS_SA","2013","33","FAYETTE","7250398","2950","320169","6927279","5525","57410","804615","6832526","30550","776900","54590","314159","15803554","1722228","0","0","17525782","2868031","20393813","POINT (-91.8443207 42.8625919)"
"2021_WAPELLO_REVS_SA","2021","90","WAPELLO","10323067","0","705080","9617987","5462","0","3335047","4621324","68500","669655","313771","445969","19077715","1200000","0","2100","20279815","10918918","31198733","POINT (-92.4094499 41.03058450000001)"
"2016_OSCEOLA_REVS_SA","2016","72","OSCEOLA","3962315","0","226433","3735882","122","0","715804","2642624","21950","279684","59550","46140","7501756","1568784","0","0","9070540","3351744","12422284","POINT (-95.6236852 43.3785704)"
"2015_VAN BUREN_REVS_SA","2015","89","VAN BUREN","2645940","3800","205800","2436340","3800","42500","331647","3545057","14900","256310","125550","78750","6834854","641178","0","2250","7478282","2446586","9924868","POINT (-91.9499871 40.7532294)"
"2015_DELAWARE_REVS_SA","2015","28","DELAWARE","8467819","4050","495079","7968690","425","30700","1114681","5643516","22050","420360","155605","465981","15822008","2141936","0","0","17963944","7132500","25096444","POINT (-91.3673502 42.471211)"
"2018_GUTHRIE_REVS_SA","2018","39","GUTHRIE","4675243","0","174500","4500743","700","37000","974624","5370799","25200","573035","98016","556631","12136748","1725000","2676458","0","16538206","7048890","23587096","POINT (-94.501055 41.6837548)"
"2018_WORTH_REVS_SA","2018","98","WORTH","4404287","29697","267358","4107232","185","21490","4414015","4240137","116750","286223","48848","15500","13250380","1162398","0","0","14412778","8383774","22796552","POINT (-93.2608476 43.3773984)"
"2021_O'BRIEN_REVS_SA","2021","71","O'BRIEN","7032689","0","344500","6688189","0","28600","780379","5395461","114500","540725","279373","98700","13925927","4275704","0","5000","18206631","7818748","26025379","POINT (-95.6248784 43.0837527)"
"2014_MITCHELL_REVS_SA","2014","66","MITCHELL","4960521","0","189080","4771441","0","20000","1844209","3852139","8500","1097743","100482","800946","12495460","1444553","6000000","1000","19941013","3505611","23446624","POINT (-92.7890315 43.3564124)"
"2014_WORTH_REVS_SA","2014","98","WORTH","4219150","17062","130037","4072051","1705","23523","3015307","5397646","19694","293761","196804","364862","13385353","1074747","0","500","14460600","6421956","20882556","POINT (-93.2608476 43.3773984)"
"2022_CLINTON_REVS_SA","2022","23","CLINTON","21584164","0","609075","20975089","5400","136400","2660074","8249116","46600","1125690","230791","277435","33706595","2103191","0","0","35809786","14634269","50444055","POINT (-90.5319724 41.8980358)"
"2020_WAPELLO_REVS_SA","2020","90","WAPELLO","9570924","0","680983","8889941","6085","16800","3220199","4896915","69100","692918","291488","503232","18586678","1200000","0","4500","19791178","10275451","30066629","POINT (-92.4094499 41.03058450000001)"
"2020_GRUNDY_REVS_SA","2020","38","GRUNDY","6346347","0","345500","6000847","0","3000","557197","7455801","8400","365250","76600","116496","14583591","2709492","0","0","17293083","5407639","22700722","POINT (-92.7914177 42.4018651)"
"2017_MILLS_REVS_SA","2017","65","MILLS","7778909","0","245555","7533354","0","57606","1094076","4743787","218300","465385","97654","78021","14288183","2367608","0","8000","16663791","6409848","23073639","POINT (-95.62132670000001 41.0334523)"
"2016_VAN BUREN_REVS_SA","2016","89","VAN BUREN","2402525","3800","193800","2204925","3800","42500","347745","3787789","14900","228310","119050","81750","6830769","664126","0","1750","7496645","2680531","10177176","POINT (-91.9499871 40.7532294)"
"2022_BOONE_REVS_SA","2022","8","BOONE","8376729","2500","385769","7988460","1510","67500","1459923","6905299","28600","1145960","241390","1517250","19355892","3984881","0","40000","23380773","5043729","28424502","POINT (-93.931671 42.0365493)"
"2015_LINN_REVS_SA","2015","57","LINN","61012021","191566","1854280","58966175","59700","700000","8288911","31513131","1012180","7514789","437100","1619309","110111295","18158571","0","43800","128313666","29619467","157933133","POINT (-91.5989646 42.0789478)"
"2021_HAMILTON_REVS_SA","2021","40","HAMILTON","9053223","0","484769","8568454","0","26100","1576273","5577191","21875","2868144","509899","1869015","21016951","3670536","0","30600","24718087","4021153","28739240","POINT (-93.7068085 42.3837722)"
"2022_WEBSTER_REVS_SA","2022","94","WEBSTER","15858233","0","601786","15256447","0","14000","4122249","21345971","69500","1043413","416525","267435","42535540","6575147","0","250000","49360687","19365091","68725778","POINT (-94.18178810000002 42.4279662)"
"2017_CHEROKEE_REVS_SA","2017","18","CHEROKEE","5824424","0","311903","5512521","0","24185","939201","5625301","67000","314965","46200","1128800","13658173","1950000","0","1000","15609173","8580434","24189607","POINT (-95.6238055 42.7356226)"
"2014_MADISON_REVS_SA","2014","61","MADISON","4998803","0","186120","4812683","0","67255","944214","4226583","50200","1028430","68048","70554","11267967","1557236","0","2500","12827703","2957594","15785297","POINT (-94.01556190000001 41.33071420000001)"
"2018_JEFFERSON_REVS_SA","2018","51","JEFFERSON","6386483","4100","350000","6032383","1040","53600","780473","3995322","30000","550470","39705","50611","11533604","1012843","0","0","12546447","5484351","18030798","POINT (-91.9488774 41.0317596)"
"2013_DELAWARE_REVS_SA","2013","28","DELAWARE","7171625","4025","269335","6898265","425","30700","972175","6799021","14250","378550","166200","163976","15423562","1931367","0","0","17354929","5164339","22519268","POINT (-91.3673502 42.471211)"
"2019_SIOUX_REVS_SA","2019","84","SIOUX","10751881","0","579300","10172581","310","53300","2142678","7863438","18875","921525","114899","1055463","22343069","3103000","0","4500","25450569","17581900","43032469","POINT (-96.1778827 43.0826174)"
"2020_CLINTON_REVS_SA","2020","23","CLINTON","19816457","0","638246","19178211","4800","136400","2712682","7637996","46450","992710","227066","256236","31192551","2101135","0","0","33293686","1304042","34597728","POINT (-90.5319724 41.8980358)"
"2012_UNION_REVS_SA","2012","88","UNION","5257870","0","164800","5093070","1950","17100","1114893","3593144","4085","408450","192263","116620","10541575","673623","1000000","0","12215198","6612784","18827982","POINT (-94.2423792 41.0277304)"
"2012_DECATUR_REVS_SA","2012","27","DECATUR","2523924","2303","94968","2426653","445","34085","297265","4397405","5100","246358","13177","201860","7622348","458000","146000","50","8226398","2170389","10396787","POINT (-93.7862815 40.7376827)"
"2021_CHEROKEE_REVS_SA","2021","18","CHEROKEE","6342431","0","342699","5999732","0","10050","952953","4729448","66200","379437","119092","1141280","13398192","2228787","0","2050","15629029","10013390","25642419","POINT (-95.6238055 42.7356226)"
"2015_DALLAS_REVS_SA","2015","25","DALLAS","19368702","0","4","19368698","0","154000","570992","8603419","195635","2437907","261345","358970","31950966","5306831","0","0","37257797","16662307","53920104","POINT (-94.0397374 41.6848862)"
"2017_JASPER_REVS_SA","2017","50","JASPER","14084699","3950","627800","13452949","4600","66200","2025524","6903837","79573","943904","133575","472836","24082998","3061770","0","0","27144768","12509107","39653875","POINT (-93.053765 41.6860394)"
"2015_SIOUX_REVS_SA","2015","84","SIOUX","9161613","0","350340","8811273","600","55000","1960655","7560882","9000","666105","26300","616375","19706190","2999458","0","4500","22710148","11911899","34622047","POINT (-96.1778827 43.0826174)"
"2017_AUDUBON_REVS_SA","2017","5","AUDUBON","3825430","0","203000","3622430","0","0","523965","3643037","10000","219010","17116","59150","8094708","910171","3430000","0","12434879","4131615","16566494","POINT (-94.9058222 41.6845893)"
"2021_ADAIR_REVS_SA","2021","1","ADAIR","5349790","0","252513","5097277","1000","30000","3918490","6414718","12400","233391","74965","28700","15810941","1181192","0","0","16992133","17276590","34268723","POINT (-94.4709413 41.3307464)"
"2022_IDA_REVS_SA","2022","47","IDA","3053270","0","142500","2910770","50","7000","1855454","3435687","14200","240400","57855","232740","8754156","2241583","0","15000","11010739","14626057","25636796","POINT (-95.5134962 42.3868747)"
"2018_SHELBY_REVS_SA","2018","83","SHELBY","6203498","0","307000","5896498","200","30000","789137","5337553","143941","303682","74109","108485","12683605","3077233","0","0","15760838","3731186","19492024","POINT (-95.31021130000002 41.6850926)"
"2021_KOSSUTH_REVS_SA","2021","55","KOSSUTH","9562788","0","510502","9052286","0","31500","1724083","7459321","26150","644850","219176","67380","19224746","2883537","31250","58000","22197533","10377892","32575425","POINT (-94.2067199 43.20413)"
"2022_SHELBY_REVS_SA","2022","83","SHELBY","6928376","0","298800","6629576","200","25000","736197","4407116","24700","319507","212000","280339","12634635","4000857","0","0","16635492","3997043","20632535","POINT (-95.31021130000002 41.6850926)"
"2022_OSCEOLA_REVS_SA","2022","72","OSCEOLA","4984202","0","257269","4726933","1026","8000","832495","3362978","22100","342048","110204","62388","9468172","1802430","0","0","11270602","4990858","16261460","POINT (-95.6236852 43.3785704)"
"2013_CLAY_REVS_SA","2013","21","CLAY","7029491","825","235798","6792868","685","31000","1068768","4031216","20607","479700","286139","299392","13010375","1127310","0","0","14137685","8730194","22867879","POINT (-95.1509194 43.0825804)"
"2016_LINN_REVS_SA","2016","57","LINN","62251138","195412","1857600","60198126","53000","652000","7999986","26392814","988326","7385348","438000","1504895","105612495","18723725","0","58150","124394370","27386026","151780396","POINT (-91.5989646 42.0789478)"
"2019_LOUISA_REVS_SA","2019","58","LOUISA","5557850","4343","452073","5101434","3500","19095","574113","12964502","28767","559840","45754","117800","19414805","1600620","0","200","21015625","6882187","27897812","POINT (-91.2596184 41.2185073)"
"2020_DELAWARE_REVS_SA","2020","28","DELAWARE","10229415","4500","571183","9653732","335","30200","1227857","6044441","36250","489600","180414","140581","17803410","2805810","0","0","20609220","11889526","32498746","POINT (-91.3673502 42.471211)"
"2011_LOUISA_REVS_SA","2011","58","LOUISA","4326589","2800","160035","4163754","4000","36500","976906","6900896","18475","493785","41071","73707","12709094","1711836","0","0","14420930","4062490","18483420","POINT (-91.2596184 41.2185073)"
"2016_CLAYTON_REVS_SA","2016","22","CLAYTON","8194959","0","526560","7668399","1146","54000","1255673","5279162","31165","515810","175416","224660","15205431","1700000","0","11000","16916431","5258857","22175288","POINT (-91.34143280000002 42.8447493)"
"2021_FAYETTE_REVS_SA","2021","33","FAYETTE","9813056","2950","602629","9207477","2525","60185","1012160","7018803","32250","879552","169128","388283","18770363","5838157","0","0","24608520","13576940","38185460","POINT (-91.8443207 42.8625919)"
"2020_PLYMOUTH_REVS_SA","2020","75","PLYMOUTH","10541860","1000","707976","9832884","1000","53900","1882196","8386851","39125","1358425","272875","914850","22742106","4025000","0","0","26767106","7526546","34293652","POINT (-96.2140431 42.7378346)"
"2021_CLINTON_REVS_SA","2021","23","CLINTON","18908514","0","615685","18292829","5400","136400","2689470","8786548","48450","975875","214950","281385","31431307","2100765","0","0","33532072","17867553","51399625","POINT (-90.5319724 41.8980358)"
"2022_HAMILTON_REVS_SA","2022","40","HAMILTON","9827198","0","513464","9313734","0","25170","1278319","5958967","60075","2153305","381871","1828473","20999914","3704801","0","7100","24711815","3910800","28622615","POINT (-93.7068085 42.3837722)"
"2017_FAYETTE_REVS_SA","2017","33","FAYETTE","8297188","2950","482111","7812127","5200","59710","800748","7837038","20100","835830","56515","475151","17902419","1980429","390000","0","20272848","3938068","24210916","POINT (-91.8443207 42.8625919)"
"2019_WAPELLO_REVS_SA","2019","90","WAPELLO","9467003","0","789726","8677277","6085","16800","3824026","4746441","67150","685955","240638","454773","18719145","1200000","0","7000","19926145","11577943","31504088","POINT (-92.4094499 41.03058450000001)"
"2014_BOONE_REVS_SA","2014","8","BOONE","7897956","3434","245134","7649388","985","80500","1199167","5833796","15600","1000883","144000","828620","16752939","2863328","0","12000","19628267","4136984","23765251","POINT (-93.931671 42.0365493)"
"2010_BUCHANAN_REVS_SA","2010","10","BUCHANAN","7068890","34185","306976","6727729","2675","55000","942862","7043714","12300","448670","255543","69747","15558240","2132037","180000","0","17870277","6795897","24666174","POINT (-91.8378392 42.4707777)"
"2021_BOONE_REVS_SA","2021","8","BOONE","8319404","2600","387626","7929178","1510","67500","1464904","6227473","29600","1120400","251390","715770","17807725","3728343","0","21000","21557068","5497174","27054242","POINT (-93.931671 42.0365493)"
"2011_WAPELLO_REVS_SA","2011","90","WAPELLO","9171339","34196","537190","8599953","5623","141000","2188329","6069450","53650","744347","283028","285681","18371061","1099500","0","3000","19473561","8768576","28242137","POINT (-92.4094499 41.03058450000001)"
"2020_CERRO GORDO_REVS_SA","2020","17","CERRO GORDO","19151675","0","929173","18222502","5300","150000","2812449","10344221","124500","1417445","486281","1298878","34861576","7521057","0","25000","42407633","18782471","61190104","POINT (-93.2608184 43.081557700000005)"
"2013_WASHINGTON_REVS_SA","2013","92","WASHINGTON","9279066","0","377686","8901380","910","65050","3502181","7275447","52550","677527","132685","392470","21000200","2403615","0","0","23403815","10471711","33875526","POINT (-91.7178676 41.335591)"
"2010_KEOKUK_REVS_SA","2010","54","KEOKUK","4558699","0","140000","4418699","102000","31005","177762","3194144","34500","557582","608345","158250","9282287","1004000","0","0","10286287","5004414","15290701","POINT (-92.1786426 41.336465)"
"2021_JASPER_REVS_SA","2021","50","JASPER","16500248","50000","230000","16220248","100","40000","1790268","7025448","133350","1359767","2575125","395401","29539707","6907484","0","0","36447191","10685273","47132464","POINT (-93.053765 41.6860394)"
"2013_LYON_REVS_SA","2013","60","LYON","5516675","0","206920","5309755","0","19070","1638791","5067583","78386","766465","150776","170546","13201372","2022017","0","10000","15233389","4247331","19480720","POINT (-96.2102924 43.380497)"
"2011_O'BRIEN_REVS_SA","2011","71","O'BRIEN","5341021","0","222900","5118121","370","12550","823049","4752865","73500","366535","141802","60425","11349217","1307666","0","0","12656883","3982992","16639875","POINT (-95.6248784 43.0837527)"
"2015_WRIGHT_REVS_SA","2015","99","WRIGHT","6414021","510","358837","6054674","270","41200","785051","7150857","17125","596782","220208","139225","15005392","1767353","0","1000","16773745","5585692","22359437","POINT (-93.7351465 42.7331189)"
"2011_HARRISON_REVS_SA","2011","43","HARRISON","6756455","6500","289900","6460055","520","51500","637547","5670566","31604","479575","261390","388282","13981039","1482497","0","0","15463536","5889344","21352880","POINT (-95.8169209 41.6828528)"
"2018_POTTAWATTAMIE_REVS_SA","2018","78","POTTAWATTAMIE","42197772","0","1472000","40725772","5000","317000","9184069","18935866","275425","2307750","92305","3137850","74981037","7925000","0","0","82906037","33178650","116084687","POINT (-95.5423935 41.3366123)"
"2016_CERRO GORDO_REVS_SA","2016","17","CERRO GORDO","16449994","0","659566","15790428","2895","163000","2469471","7901273","139500","1415886","223547","1300173","29406173","6244339","0","12000","35662512","12857592","48520104","POINT (-93.2608184 43.081557700000005)"
"2017_WARREN_REVS_SA","2017","91","WARREN","13513809","2600","614900","12896309","2600","115000","422598","7750909","67200","1320461","121739","414615","23111431","3250000","0","2500","26363931","10384865","36748796","POINT (-93.5613594 41.3343735)"
"2014_DALLAS_REVS_SA","2014","25","DALLAS","18894927","0","4","18894923","0","154000","572249","8531484","127985","2376757","267045","332474","31256917","4291077","0","0","35547994","21533062","57081056","POINT (-94.0397374 41.6848862)"
"2021_DICKINSON_REVS_SA","2021","30","DICKINSON","11492292","1140","299475","11191677","1140","67300","2061431","6513000","67100","772295","332465","355202","21361610","4843260","1360000","500","27565370","11702803","39268173","POINT (-95.1508301 43.3779848)"
"2015_AUDUBON_REVS_SA","2015","5","AUDUBON","3613895","0","160000","3453895","0","0","401582","3094728","10500","198460","22725","22250","7204140","999190","630000","0","8833330","3431294","12264624","POINT (-94.9058222 41.6845893)"
"2019_WRIGHT_REVS_SA","2019","99","WRIGHT","7383997","210","450722","6933065","300","41400","860457","6369622","17550","563086","234038","265100","15284618","2038527","0","2500","17325645","6869009","24194654","POINT (-93.7351465 42.7331189)"
"2018_MITCHELL_REVS_SA","2018","66","MITCHELL","5447593","0","269050","5178543","0","20000","4388966","5208072","6000","1434068","210624","66600","16512873","1344160","1710000","1000","19568033","3914982","23483015","POINT (-92.7890315 43.3564124)"
"2011_BUENA VISTA_REVS_SA","2011","11","BUENA VISTA","7855955","60210","276980","7518765","2725","42200","937067","4685968","39761","567740","133049","88800","14016075","1860825","0","500","15877400","5171258","21048658","POINT (-95.15114900000002 42.7354936)"
"2013_EMMET_REVS_SA","2013","32","EMMET","4499200","115","175600","4323485","550","31300","403206","3354147","13200","292881","22150","140725","8581644","873665","0","1000","9456309","2553076","12009385","POINT (-94.6784803 43.37802250000001)"
"2014_POCAHONTAS_REVS_SA","2014","76","POCAHONTAS","6162144","0","220595","5941549","900","15750","487210","3901179","26400","411035","148280","34020","10966323","1090000","0","10000","12066323","4462131","16528454","POINT (-94.67874660000001 42.73413510000001)"
"2012_LUCAS_REVS_SA","2012","59","LUCAS","3239836","1050","148680","3090106","1310","9100","358415","3253806","450","214865","37150","431900","7397102","780981","0","500","8178583","1563652","9742235","POINT (-93.3277207 41.0293738)"
"2018_WAYNE_REVS_SA","2018","93","WAYNE","3109914","0","110000","2999914","3300","35000","316629","3305941","0","637180","68532","113455","7479951","517010","0","0","7996961","5842566","13839527","POINT (-93.3273639 40.73947020000001)"
"2021_OSCEOLA_REVS_SA","2021","72","OSCEOLA","4942809","0","265488","4677321","590","17581","831552","3357378","29550","347148","143355","83390","9487865","1717162","0","0","11205027","4121590","15326617","POINT (-95.6236852 43.3785704)"
"2020_GUTHRIE_REVS_SA","2020","39","GUTHRIE","6449914","0","161000","6288914","700","37000","1559131","5359997","39200","780490","140796","488950","14695178","1988268","300508","500","16984454","4738186","21722640","POINT (-94.501055 41.6837548)"
"2020_WAYNE_REVS_SA","2020","93","WAYNE","4196045","0","212389","3983656","0","26153","463714","3442269","8988","541601","78509","53059","8597949","693313","0","0","9291262","5237742","14529004","POINT (-93.3273639 40.73947020000001)"
"2014_WAYNE_REVS_SA","2014","93","WAYNE","3400546","26880","132100","3241566","3790","0","428817","3138880","5208","415945","32692","84890","7351788","548000","0","0","7899788","3966465","11866253","POINT (-93.3273639 40.73947020000001)"
"2011_DAVIS_REVS_SA","2011","26","DAVIS","3070669","0","154178","2916491","293","35634","421258","2629319","888","167625","140921","148773","6461202","630301","0","0","7091503","3080065","10171568","POINT (-92.4097173 40.7476891)"
"2012_DELAWARE_REVS_SA","2012","28","DELAWARE","7471443","4025","291102","7176316","425","30700","981811","6331738","11250","396520","175700","187996","15292456","1935579","0","0","17228035","3980377","21208412","POINT (-91.3673502 42.471211)"
"2013_HARRISON_REVS_SA","2013","43","HARRISON","7593694","6500","267400","7319794","1075","51500","654433","6268535","33075","550455","109480","193715","15182062","1590000","0","0","16772062","8415255","25187317","POINT (-95.8169209 41.6828528)"
"2019_HARRISON_REVS_SA","2019","43","HARRISON","8060170","2600","437125","7620445","3100","60500","687082","5386917","36050","646295","123925","326350","14890664","2213000","0","0","17103664","10357132","27460796","POINT (-95.8169209 41.6828528)"
"2010_POTTAWATTAMIE_REVS_SA","2010","78","POTTAWATTAMIE","28385346","0","723350","27661996","15050","325000","8744300","20171366","319300","2315795","839920","2841150","63233877","5924584","0","0","69158461","22233223","91391684","POINT (-95.5423935 41.3366123)"
"2015_LYON_REVS_SA","2015","60","LYON","6056588","0","261310","5795278","0","19070","1841669","4908285","76825","843690","151024","186437","13822278","2517236","0","30000","16369514","6116185","22485699","POINT (-96.2102924 43.380497)"
"2017_MADISON_REVS_SA","2017","61","MADISON","5618529","0","294603","5323926","33","67255","1074776","5307435","52493","1002575","83521","51523","12963537","1634781","0","5000","14603318","3420162","18023480","POINT (-94.01556190000001 41.33071420000001)"
"2021_WEBSTER_REVS_SA","2021","94","WEBSTER","15267104","0","0","15267104","0","125959","4340644","12790812","69500","1078250","375442","332981","34380692","5986807","0","0","40367499","24764353","65131852","POINT (-94.18178810000002 42.4279662)"
"2011_WINNEBAGO_REVS_SA","2011","95","WINNEBAGO","4436663","0","96790","4339873","1630","28200","763673","4143289","31120","832506","291642","164079","10596012","1357060","14000000","0","25953072","4368212","30321284","POINT (-93.7341955 43.37756780000001)"
"2015_HARRISON_REVS_SA","2015","43","HARRISON","8052396","3750","379900","7668746","5900","51000","686890","3788379","33075","642185","123040","199760","13198975","2011500","0","0","15210475","9838566","25049041","POINT (-95.8169209 41.6828528)"
"2016_POCAHONTAS_REVS_SA","2016","76","POCAHONTAS","6391547","0","240202","6151345","500","15750","477218","3564425","11500","390075","134130","197150","10942093","1090000","0","8000","12040093","10829406","22869499","POINT (-94.67874660000001 42.73413510000001)"
"2019_BUENA VISTA_REVS_SA","2019","11","BUENA VISTA","9415057","47075","544828","8823154","590","17400","1091313","5971501","83653","703245","128185","252552","17071593","2570175","0","2750","19644518","8493416","28137934","POINT (-95.15114900000002 42.7354936)"
"2016_WAYNE_REVS_SA","2016","93","WAYNE","3571964","42418","162200","3367346","12100","40750","359573","3784140","11410","446340","102100","99167","8222926","533515","0","0","8756441","4544286","13300727","POINT (-93.3273639 40.73947020000001)"
"2020_TAMA_REVS_SA","2020","86","TAMA","9650405","0","598398","9052007","1299","27708","1732577","9758020","19850","555380","135822","236673","21519336","2914183","0","1800","24435319","9693795","34129114","POINT (-92.5325425 42.07981170000001)"
"2014_SAC_REVS_SA","2014","81","SAC","5242080","6585","224887","5010608","3249","29044","551004","4086686","17500","883029","70958","34700","10686778","1375705","0","58000","12120483","3754443","15874926","POINT (-95.1053946 42.3862604)"
"2016_JACKSON_REVS_SA","2016","49","JACKSON","6687899","0","303190","6384709","614","3820","956961","4399731","32360","586255","352472","148691","12865613","980000","0","10025","13855638","5392941","19248579","POINT (-90.5742294 42.1717426)"
"2015_EMMET_REVS_SA","2015","32","EMMET","4515177","185","192400","4322592","300","21200","370126","2807804","13500","314535","21690","161024","8032771","959615","0","0","8992386","3220184","12212570","POINT (-94.6784803 43.37802250000001)"
"2016_HENRY_REVS_SA","2016","44","HENRY","7423722","0","263546","7160176","3467","53300","514866","3880997","56100","478070","59640","62600","12269216","1373344","0","0","13642560","7018408","20660968","POINT (-91.5445241 40.9879383)"
"2014_WEBSTER_REVS_SA","2014","94","WEBSTER","12119229","0","449640","11669589","1200","105000","2815113","9780139","54900","977192","282734","117696","25803563","3728430","4500000","0","34031993","12012095","46044088","POINT (-94.18178810000002 42.4279662)"
"2022_DECATUR_REVS_SA","2022","27","DECATUR","4071656","0","251100","3820556","0","0","323924","4513263","400","274055","16000","457964","9406162","668691","0","0","10074853","3243040","13317893","POINT (-93.7862815 40.7376827)"
"2020_DECATUR_REVS_SA","2020","27","DECATUR","4490515","0","251900","4238615","0","31000","316859","3748826","0","283915","16000","195822","8831037","586241","0","0","9417278","3070032","12487310","POINT (-93.7862815 40.7376827)"
"2022_CLARKE_REVS_SA","2022","20","CLARKE","5028547","2993","208630","4816924","960","18000","321753","3864456","40850","331080","32017","271750","9697790","926819","0","0","10624609","3858585","14483194","POINT (-93.78515790000002 41.0290323)"
"2015_WINNESHIEK_REVS_SA","2015","96","WINNESHIEK","8479954","410","454253","8025291","410","25425","1399748","8010147","14700","682850","148202","821639","19128412","2337543","0","1015000","22480955","5034962","27515917","POINT (-91.8437074 43.2906746)"
"2016_TAMA_REVS_SA","2016","86","TAMA","8693253","0","420694","8272559","798","19238","787092","6401054","12850","580535","61000","563613","16698739","2150000","0","5000","18853739","8159976","27013715","POINT (-92.5325425 42.07981170000001)"
"2020_JASPER_REVS_SA","2020","50","JASPER","16190804","110100","531100","15549604","100","40000","1890358","9118743","133350","1030547","232177","515331","28510210","6241336","0","10000","34761546","14670496","49432042","POINT (-93.053765 41.6860394)"
"2019_RINGGOLD_REVS_SA","2019","80","RINGGOLD","3621853","0","142800","3479053","700","24100","398511","4852048","0","575861","39740","29850","9399863","813975","0","0","10213838","4149111","14362949","POINT (-94.2439719 40.7352023)"
"2021_MONONA_REVS_SA","2021","67","MONONA","7151016","2218","0","7148798","670","15420","482183","8708591","8225","279022","116590","300757","17060256","2036441","0","35000","19131697","5701058","24832755","POINT (-95.9599235 42.0516663)"
"2015_JONES_REVS_SA","2015","53","JONES","7541782","1030","402609","7138143","1150","44450","1017528","5640547","67618","585890","181593","314859","14991778","1935000","0","0","16926778","4603657","21530435","POINT (-91.1314352 42.1212397)"
"2012_CASS_REVS_SA","2012","15","CASS","5437302","450","215520","5221332","947","35770","975593","6722626","17150","336266","167045","541883","14018612","1800837","0","0","15819449","2248393","18067842","POINT (-94.9278266 41.3314876)"
"2017_CARROLL_REVS_SA","2017","14","CARROLL","6757067","0","509875","6247192","0","15000","1320640","5772055","51100","1776520","366728","474780","16024015","2160446","0","0","18184461","6177289","24361750","POINT (-94.8605593 42.0362382)"
"2010_WOODBURY_REVS_SA","2010","97","WOODBURY","23735025","0","848336","22886689","10050","366000","5381770","13554870","55450","1902550","1002731","118261","45278371","6475038","465000","0","52218409","14264371","66482780","POINT (-96.0447673 42.3897169)"
"2016_DES MOINES_REVS_SA","2016","29","DES MOINES","12971407","9877","785532","12175998","5650","130800","2511700","6313431","49400","963463","177409","387607","22715458","2009135","2207066","0","26931659","9182287","36113946","POINT (-91.1814707 40.9231829)"
"2018_HUMBOLDT_REVS_SA","2018","46","HUMBOLDT","5348627","0","335115","5013512","786","24800","760052","3390161","7700","313400","140320","46300","9697031","1853918","0","4500","11555449","7124595","18680044","POINT (-94.2071868 42.7764686)"
"2013_WOODBURY_REVS_SA","2013","97","WOODBURY","25833201","0","753000","25080201","5750","447500","5243558","15449213","24000","2112900","1264922","341800","49969844","6240476","1640000","0","57850320","9877617","67727937","POINT (-96.0447673 42.3897169)"
"2021_DAVIS_REVS_SA","2021","26","DAVIS","4549746","0","0","4549746","0","0","911860","5217049","1200","371943","270267","231745","11553810","1114170","0","0","12667980","3029321","15697301","POINT (-92.4097173 40.7476891)"
"2016_KEOKUK_REVS_SA","2016","54","KEOKUK","4709262","100000","267300","4341962","1250","6000","149932","3377818","45000","569955","142200","186500","8820617","1346150","0","0","10166767","4303360","14470127","POINT (-92.1786426 41.336465)"
"2022_POCAHONTAS_REVS_SA","2022","76","POCAHONTAS","6909344","100","291200","6618044","100","11025","362643","5658069","46500","551666","111855","77650","13437552","1710286","0","15000","15162838","11631865","26794703","POINT (-94.67874660000001 42.73413510000001)"
"2020_BOONE_REVS_SA","2020","8","BOONE","8069868","2800","387626","7679442","1510","67500","1464445","5977937","35800","1110760","232800","822450","17392644","3593111","0","21000","21006755","5919493","26926248","POINT (-93.931671 42.0365493)"
"2021_BUENA VISTA_REVS_SA","2021","11","BUENA VISTA","11442653","57214","577676","10807763","650","22600","1198249","7467172","115860","769530","184023","146375","20712222","2748709","1845000","250","25306181","5836474","31142655","POINT (-95.15114900000002 42.7354936)"
"2019_WINNEBAGO_REVS_SA","2019","95","WINNEBAGO","6856599","0","40350","6816249","135","12060","3654886","5001630","16250","1285538","392852","476708","17656308","1564727","0","0","19221035","18248485","37469520","POINT (-93.7341955 43.37756780000001)"
"2017_BREMER_REVS_SA","2017","9","BREMER","8464889","0","447785","8017104","250","31200","1240609","6173974","277130","926650","222252","324153","17213322","3159287","0","100","20372709","11443342","31816051","POINT (-92.31805480000001 42.7745873)"
"2015_CLAY_REVS_SA","2015","21","CLAY","7344533","825","543074","6800634","325","41000","1084400","4516679","31937","497737","331417","845335","14149464","2409294","0","0","16558758","6907043","23465801","POINT (-95.1509194 43.0825804)"
"2021_MAHASKA_REVS_SA","2021","62","MAHASKA","10050651","0","200706","9849945","0","42600","1761415","6272167","10100","684945","229273","645725","19496170","2916400","0","0","22412570","11047738","33460308","POINT (-92.6409094 41.3352035)"
"2022_MAHASKA_REVS_SA","2022","62","MAHASKA","9981517","0","200706","9780811","0","42600","1975805","4769120","16900","669220","108056","351205","17713717","2353648","0","0","20067365","17271731","37339096","POINT (-92.6409094 41.3352035)"
"2017_HUMBOLDT_REVS_SA","2017","46","HUMBOLDT","5168012","0","269343","4898669","949","26975","597107","3071948","8000","303000","177920","227000","9311568","1634137","0","4500","10950205","5247084","16197289","POINT (-94.2071868 42.7764686)"
"2022_POWESHIEK_REVS_SA","2022","79","POWESHIEK","8246334","0","260900","7985434","0","0","1193740","6764355","24350","634740","72038","159300","16833957","3431811","0","0","20265768","14021121","34286889","POINT (-92.53146840000001 41.6864422)"
"2022_HENRY_REVS_SA","2022","44","HENRY","9868504","0","583265","9285239","1607","53300","1121761","5609130","33050","664270","86280","121300","16975937","1698811","0","0","18674748","5350169","24024917","POINT (-91.5445241 40.9879383)"
"2021_HARRISON_REVS_SA","2021","43","HARRISON","8452460","2300","426675","8023485","1150","53000","674082","6113713","36050","672085","209605","355315","16138485","2376000","0","0","18514485","9130283","27644768","POINT (-95.8169209 41.6828528)"
"2016_MADISON_REVS_SA","2016","61","MADISON","5219075","0","259103","4959972","0","67255","991323","5788415","47993","1031623","87048","54198","13027827","1609690","0","7500","14645017","4203483","18848500","POINT (-94.01556190000001 41.33071420000001)"
"2022_AUDUBON_REVS_SA","2022","5","AUDUBON","5173098","0","0","5173098","0","0","905883","3250481","40000","265530","2522","2720","9640234","8404175","4980000","6000","23030409","8237590","31267999","POINT (-94.9058222 41.6845893)"
"2020_O'BRIEN_REVS_SA","2020","71","O'BRIEN","6032256","0","327150","5705106","15","33500","732570","5456414","115500","559815","248511","140929","12992360","3792112","0","5000","16789472","8093126","24882598","POINT (-95.6248784 43.0837527)"
"2020_MADISON_REVS_SA","2020","61","MADISON","7470556","0","363108","7107448","33","67255","1159233","14242222","68071","1062990","144963","91660","23943875","1892354","0","9500","25845729","4334279","30180008","POINT (-94.01556190000001 41.33071420000001)"
"2014_MAHASKA_REVS_SA","2014","62","MAHASKA","6830362","0","127382","6702980","1900","25700","1433342","3900688","15075","569625","241495","579025","13469830","1964191","0","0","15434021","8996767","24430788","POINT (-92.6409094 41.3352035)"
"2019_WEBSTER_REVS_SA","2019","94","WEBSTER","13038008","0","830925","12207083","-2639","106279","3929228","12639535","74500","1069545","313860","359535","30696926","6458555","0","0","37155481","14322573","51478054","POINT (-94.18178810000002 42.4279662)"
"2011_PLYMOUTH_REVS_SA","2011","75","PLYMOUTH","7120797","0","278539","6842258","250","49500","3014410","7316709","20200","862040","195000","284000","18584367","3047000","100000","0","21731367","2228838","23960205","POINT (-96.2140431 42.7378346)"
"2019_CLAY_REVS_SA","2019","21","CLAY","8010141","285","474498","7535358","130","38810","1429561","5354589","31954","605922","328611","133650","15458585","2401902","0","0","17860487","7729553","25590040","POINT (-95.1509194 43.0825804)"
"2017_DES MOINES_REVS_SA","2017","29","DES MOINES","12725094","9512","784053","11931529","3713","130500","2675275","7613594","29849","910568","173843","404948","23873819","2074609","2747100","80000","28775528","11009794","39785322","POINT (-91.1814707 40.9231829)"
"2010_CARROLL_REVS_SA","2010","14","CARROLL","6333334","0","235345","6097989","0","30000","1043422","5405970","104600","1578620","249344","513680","15023625","1289000","0","0","16312625","5967114","22279739","POINT (-94.8605593 42.0362382)"
"2011_DUBUQUE_REVS_SA","2011","31","DUBUQUE","25449934","6725","701348","24741861","6725","203700","4886449","23087721","61500","3480941","350010","368198","57187105","4469944","0","0","61657049","9253137","70910186","POINT (-90.8824564 42.468832)"
"2020_CALHOUN_REVS_SA","2020","13","CALHOUN","7550343","21789","336900","7191654","2293","29763","470429","5911884","8600","1060670","88670","188075","14952038","1923299","0","0","16875337","9766254","26641591","POINT (-94.6404136 42.385184800000005)"
"2015_PLYMOUTH_REVS_SA","2015","75","PLYMOUTH","8665925","575","391778","8273572","1875","68000","3878349","7519472","24200","1103610","151455","1081161","22101694","3885543","100000","0","26087237","6909372","32996609","POINT (-96.2140431 42.7378346)"
"2022_LUCAS_REVS_SA","2022","59","LUCAS","3696459","0","225200","3471259","24500","27000","627274","3135077","250","263895","75000","192564","7816819","803106","0","500","8620425","2846924","11467349","POINT (-93.3277207 41.0293738)"
"2010_HARDIN_REVS_SA","2010","42","HARDIN","5888229","0","202640","5685589","1035","33715","1022892","7749399","23750","421410","182600","94725","15215115","2746995","0","0","17962110","5917969","23880079","POINT (-93.2404025 42.3838803)"
"2017_TAYLOR_REVS_SA","2017","87","TAYLOR","3747210","3230","264877","3479103","715","18810","312203","5458848","6398","191025","40705","120218","9628025","796290","0","25000","10449315","3837939","14287254","POINT (-94.6964148 40.73743240000001)"
"2013_PLYMOUTH_REVS_SA","2013","75","PLYMOUTH","7962522","0","271100","7691422","295","53000","3770240","9221162","20600","1028270","166320","421700","22373009","2759100","100000","0","25232109","3242583","28474692","POINT (-96.2140431 42.7378346)"
"2015_BREMER_REVS_SA","2015","9","BREMER","8002827","0","409647","7593180","0","14000","1204939","5833237","277100","866000","258503","497600","16544559","2885323","0","750","19430632","9994847","29425479","POINT (-92.31805480000001 42.7745873)"
"2016_BUTLER_REVS_SA","2016","12","BUTLER","6632421","0","356000","6276421","990","46000","954270","5317825","33300","469311","372887","139225","13610229","2174715","0","0","15784944","8494537","24279481","POINT (-92.7901934 42.7315661)"
"2011_FREMONT_REVS_SA","2011","36","FREMONT","3515566","1550","173013","3341003","1650","24045","1082095","4102779","20355","256535","145615","265956","9240033","855661","145840","24000","10265534","3233875","13499409","POINT (-95.6046765 40.7455892)"
"2010_PALO ALTO_REVS_SA","2010","74","PALO ALTO","5164530","6500","222700","4935330","210","6400","839033","3878345","28550","581900","586873","230350","11086991","1082812","0","0","12169803","16124048","28293851","POINT (-94.6781371 43.0820643)"
"2011_DICKINSON_REVS_SA","2011","30","DICKINSON","7545997","27580","83350","7435067","10216","67900","2097091","4535631","48700","616263","351170","345355","15507393","2854176","0","2000","18363569","7869699","26233268","POINT (-95.1508301 43.3779848)"
"2013_IDA_REVS_SA","2013","47","IDA","2553626","350","73350","2479926","350","4000","555079","2713533","19338","205950","2910","228200","6209286","953869","0","0","7163155","2929367","10092522","POINT (-95.5134962 42.3868747)"
"2012_HAMILTON_REVS_SA","2012","40","HAMILTON","7244317","5000","243953","6995364","3900","30400","1101737","5659527","16975","1103441","96629","2015152","17023125","2446558","0","0","19469683","4485608","23955291","POINT (-93.7068085 42.3837722)"
"2011_BLACK HAWK_REVS_SA","2011","7","BLACK HAWK","29613425","38257","885001","28690167","23000","384000","3908466","15047195","464850","4079196","894251","1344368","54835493","2129046","11225000","0","68189539","10806691","78996230","POINT (-92.3088197 42.4700957)"
"2012_IDA_REVS_SA","2012","47","IDA","2438979","350","81000","2357629","380","4000","555838","2405151","18731","182250","3010","194600","5721589","793512","0","0","6515101","2708688","9223789","POINT (-95.5134962 42.3868747)"
"2022_CASS_REVS_SA","2022","15","CASS","7863375","0","487248","7376127","1225","32300","2092022","4976310","17490","362510","194925","258461","15311370","4461680","0","0","19773050","10671894","30444944","POINT (-94.9278266 41.3314876)"
"2018_ADAIR_REVS_SA","2018","1","ADAIR","4869088","0","259010","4610078","0","31000","2967748","3961584","15850","198180","44355","34210","11863005","1397472","5000000","10000","18270477","9710705","27981182","POINT (-94.4709413 41.3307464)"
"2010_ALLAMAKEE_REVS_SA","2010","3","ALLAMAKEE","4928757","0","240567","4688190","325","35800","818196","5298675","54086","224439","210401","43720","11373832","1429029","0","5000","12807861","3966897","16774758","POINT (-91.3780923 43.2842838)"
"2020_WOODBURY_REVS_SA","2020","97","WOODBURY","31896478","0","1281051","30615427","7405","369500","7053324","10368026","54750","2742485","386553","1768150","53365620","9209738","1767856","0","64343214","14521849","78865063","POINT (-96.0447673 42.3897169)"
"2019_IOWA_REVS_SA","2019","48","IOWA","8419070","6605","496011","7916454","4305","36300","1849667","7489674","41182","1965310","325319","98706","19726917","1315000","0","0","21041917","9998257","31040174","POINT (-92.065524 41.6863229)"
"2022_KEOKUK_REVS_SA","2022","54","KEOKUK","6139129","23050","350600","5765479","1500","41000","576255","4179736","52000","565470","219550","104564","11505554","2238160","7000","0","13750714","3668191","17418905","POINT (-92.1786426 41.336465)"
"2012_MONTGOMERY_REVS_SA","2012","69","MONTGOMERY","4923827","2100","218331","4703396","1015","15800","569833","4139952","8600","387780","68330","44800","9939506","1022145","0","0","10961651","7763302","18724953","POINT (-95.1563758 41.03014)"
"2016_HAMILTON_REVS_SA","2016","40","HAMILTON","7400470","5000","355946","7039524","1500","21500","1194387","6523456","19475","1444824","243775","2332325","18820766","3094680","0","4100","21919546","18218106","40137652","POINT (-93.7068085 42.3837722)"
"2013_MARSHALL_REVS_SA","2013","64","MARSHALL","11951191","0","402065","11549126","3200","102000","1947362","7881562","241250","740629","252275","120600","22838004","2184000","0","12500","25034504","10385329","35419833","POINT (-92.9987706 42.0358499)"
"2018_CARROLL_REVS_SA","2018","14","CARROLL","6785093","0","531960","6253133","0","15000","1301280","5353979","52100","1781170","349848","306080","15412590","3050516","0","0","18463106","7204767","25667873","POINT (-94.8605593 42.0362382)"
"2012_BOONE_REVS_SA","2012","8","BOONE","7574175","5600","246971","7321604","8500","80500","1091199","7502001","14400","963280","167615","562600","17711699","2164113","514000","12000","20401812","4325917","24727729","POINT (-93.931671 42.0365493)"
"2015_CARROLL_REVS_SA","2015","14","CARROLL","6394427","0","635374","5759053","0","20000","1021828","4934496","59050","1745700","231676","494530","14266333","2049000","0","0","16315333","7117879","23433212","POINT (-94.8605593 42.0362382)"
"2013_CASS_REVS_SA","2013","15","CASS","5903092","750","235555","5666787","835","35770","975564","6272162","17100","319281","152435","593734","14033668","2419415","0","0","16453083","3301700","19754783","POINT (-94.9278266 41.3314876)"
"2019_DUBUQUE_REVS_SA","2019","31","DUBUQUE","33559655","4174","1842852","31712629","4174","202250","5049200","10248031","106650","2396691","483393","240747","50443765","5361392","16149513","0","71954670","26890171","98844841","POINT (-90.8824564 42.468832)"
"2015_IDA_REVS_SA","2015","47","IDA","2366209","1700","138400","2226109","300","6000","524398","2871190","17200","207130","3960","155725","6012012","1106094","0","0","7118106","3350965","10469071","POINT (-95.5134962 42.3868747)"
"2016_MARSHALL_REVS_SA","2016","64","MARSHALL","12656600","0","670799","11985801","0","80000","1809996","6847107","41366","790300","224078","780100","22558748","2585000","0","10000","25153748","7931670","33085418","POINT (-92.9987706 42.0358499)"
"2017_PAGE_REVS_SA","2017","73","PAGE","5456726","3000","279479","5174247","2250","31040","594292","4044918","18275","346045","58271","248229","10517567","1299967","0","25000","11842534","5804580","17647114","POINT (-95.1501747 40.7391444)"
"2020_MILLS_REVS_SA","2020","65","MILLS","10148934","0","443533","9705401","0","55848","1441169","7857939","312925","531555","141914","227460","20274211","2601886","0","0","22876097","8000340","30876437","POINT (-95.62132670000001 41.0334523)"
"2021_SCOTT_REVS_SA","2021","82","SCOTT","59872149","20700","2385928","57465521","20700","590000","7403324","11978083","796295","6495547","1183299","1172057","87104826","14563763","0","220000","101888589","33467207","135355796","POINT (-90.6232428 41.6370978)"
"2022_WRIGHT_REVS_SA","2022","99","WRIGHT","8915810","300","483115","8432395","390","21050","3511383","6692302","17650","492390","233291","142979","19543830","2540151","0","3000","22086981","5800829","27887810","POINT (-93.7351465 42.7331189)"
"2014_ALLAMAKEE_REVS_SA","2014","3","ALLAMAKEE","5841461","0","277879","5563582","0","0","818010","4366244","21459","306460","161721","19650","11257126","1582034","0","5500","12844660","3452013","16296673","POINT (-91.3780923 43.2842838)"
"2020_HUMBOLDT_REVS_SA","2020","46","HUMBOLDT","5908834","0","315712","5593122","508","27800","782294","3229657","7200","330750","230315","113000","10314646","1911783","0","5000","12231429","4131778","16363207","POINT (-94.2071868 42.7764686)"
"2015_MARSHALL_REVS_SA","2015","64","MARSHALL","12233482","0","692902","11540580","0","0","1850394","6550485","46727","765055","218713","195400","21167354","2846000","1225000","12500","25250854","9369417","34620271","POINT (-92.9987706 42.0358499)"
"2020_SCOTT_REVS_SA","2020","82","SCOTT","56084819","12619","2321650","53750550","12619","590000","7195284","12187023","832645","6413272","1029099","1032496","83042988","15928447","0","210000","99181435","36357975","135539410","POINT (-90.6232428 41.6370978)"
"2021_WRIGHT_REVS_SA","2021","99","WRIGHT","8645532","200","488569","8156763","490","41650","3445330","6399710","17730","489870","254048","224520","19030111","1976395","1140000","5000","22151506","4803983","26955489","POINT (-93.7351465 42.7331189)"
"2016_SAC_REVS_SA","2016","81","SAC","5602097","1955","351787","5248355","3180","22100","654213","4483930","17500","963118","57467","29950","11479813","1504107","0","123000","13106920","5261838","18368758","POINT (-95.1053946 42.3862604)"
"2020_GREENE_REVS_SA","2020","37","GREENE","6262499","0","329150","5933349","0","20000","746848","4527760","61525","854550","60547","627300","12831879","1613340","0","0","14445219","3397860","17843079","POINT (-94.3968356 42.0362394)"
"2021_POWESHIEK_REVS_SA","2021","79","POWESHIEK","7933011","0","253200","7679811","0","0","1129501","6478590","24450","582640","281145","180400","16356537","3938923","0","0","20295460","10634712","30930172","POINT (-92.53146840000001 41.6864422)"
"2015_FREMONT_REVS_SA","2015","36","FREMONT","4791649","0","189143","4602506","1400","24045","1053929","3953552","26400","274653","79580","73249","10089314","1150835","5144648","24000","16408797","4568710","20977507","POINT (-95.6046765 40.7455892)"
"2019_MARION_REVS_SA","2019","63","MARION","12480136","0","770984","11709152","500","53000","1286320","8385909","41100","1270720","118828","174674","23040203","2464823","0","1000","25506026","12017591","37523617","POINT (-93.0994367 41.3344515)"
"2021_WOODBURY_REVS_SA","2021","97","WOODBURY","34066132","0","1506815","32559317","12700","409500","7369324","11014878","54200","2642649","520317","723699","55306584","9771696","1599066","0","66677346","13635736","80313082","POINT (-96.0447673 42.3897169)"
"2017_SAC_REVS_SA","2017","81","SAC","5502472","2125","450365","5049982","2470","54800","651876","4995959","6500","979943","38468","33450","11813448","1478267","0","127000","13418715","5510531","18929246","POINT (-95.1053946 42.3862604)"
"2018_ALLAMAKEE_REVS_SA","2018","3","ALLAMAKEE","7159034","0","403010","6756024","0","0","1017279","5424498","21489","323177","123264","46450","13712181","1901128","105000","5500","15723809","5421830","21145639","POINT (-91.3780923 43.2842838)"
"2015_WASHINGTON_REVS_SA","2015","92","WASHINGTON","8690409","0","362104","8328305","340","70100","2597081","5450764","53550","714651","134403","375900","17725094","2523849","0","1000","20249943","6642233","26892176","POINT (-91.7178676 41.335591)"
"2016_MONTGOMERY_REVS_SA","2016","69","MONTGOMERY","5623189","0","329128","5294061","1410","46715","591257","3512393","6975","276919","42722","65244","9837696","850000","0","0","10687696","5628693","16316389","POINT (-95.1563758 41.03014)"
"2017_DAVIS_REVS_SA","2017","26","DAVIS","4001245","0","197306","3803939","370","15110","554815","4295694","2292","179552","108142","641378","9601292","775594","0","0","10376886","2189005","12565891","POINT (-92.4097173 40.7476891)"
"2018_WOODBURY_REVS_SA","2018","97","WOODBURY","30258094","0","1694436","28563658","11240","394000","5921571","10112505","55000","3214600","294000","265860","48832434","9987470","1646380","0","60466284","13337129","73803413","POINT (-96.0447673 42.3897169)"
"2019_FREMONT_REVS_SA","2019","36","FREMONT","5404392","0","299105","5105287","1060","24045","586076","4266628","20700","292845","84555","79561","10460757","1330499","104648","104000","11999904","3868759","15868663","POINT (-95.6046765 40.7455892)"
"2019_CEDAR_REVS_SA","2019","16","CEDAR","8845308","0","484693","8360615","376","42200","908962","6183664","39519","1204859","117961","95706","16953862","2542162","35000","0","19531024","5651864","25182888","POINT (-91.1324125 41.7723207)"
"2022_WARREN_REVS_SA","2022","91","WARREN","18950642","0","734900","18215742","1200","104340","2383282","7931285","120575","1595695","285720","256486","30894325","4825000","0","0","35719325","31015526","66734851","POINT (-93.5613594 41.3343735)"
"2013_ADAMS_REVS_SA","2013","2","ADAMS","2625153","0","105957","2519196","210","12600","763270","2910141","10200","396080","115988","35120","6762805","837865","0","0","7600670","2615220","10215890","POINT (-94.6991849 41.02898390000001)"
"2021_IDA_REVS_SA","2021","47","IDA","2928448","0","137000","2791448","50","10000","1510985","3796677","13200","230665","54055","188425","8595505","1684723","0","15000","10295228","6808373","17103601","POINT (-95.5134962 42.3868747)"
"2014_CERRO GORDO_REVS_SA","2014","17","CERRO GORDO","16152761","11300","452100","15689361","2150","163000","2307680","8301202","10250","1023125","264074","1121145","28881987","5556326","0","10000","34448313","11201274","45649587","POINT (-93.2608184 43.081557700000005)"
"2019_PLYMOUTH_REVS_SA","2019","75","PLYMOUTH","10076918","1000","497013","9578905","1500","53900","1890998","10001195","49125","1263275","182025","607125","23628048","4262300","0","0","27890348","8365019","36255367","POINT (-96.2140431 42.7378346)"
"2017_LOUISA_REVS_SA","2017","58","LOUISA","4977808","4954","313531","4659323","2000","45865","1331027","3506750","17100","585485","35231","31000","10213781","1777380","0","300","11991461","5004095","16995556","POINT (-91.2596184 41.2185073)"
"2022_MARSHALL_REVS_SA","2022","64","MARSHALL","14322093","0","726518","13595575","1000","80000","2544918","8351646","55335","828323","217525","2754500","28428822","4179000","0","10000","32617822","13933567","46551389","POINT (-92.9987706 42.0358499)"
"2016_DALLAS_REVS_SA","2016","25","DALLAS","20802783","0","4","20802779","0","154000","572031","10301755","193165","2585850","262170","325850","35197600","5854906","0","0","41052506","24901865","65954371","POINT (-94.0397374 41.6848862)"
"2014_DICKINSON_REVS_SA","2014","30","DICKINSON","8477432","19545","96300","8361587","4300","62500","1917561","4484892","62300","662150","135990","1240740","16932020","3316981","0","1000","20250001","9329251","29579252","POINT (-95.1508301 43.3779848)"
"2015_CHICKASAW_REVS_SA","2015","19","CHICKASAW","5196786","475","239015","4957296","335","3550","811840","3861397","8300","570701","110332","84950","10408701","1682564","0","500","12091765","5806324","17898089","POINT (-92.3176637 43.06004140000001)"
"2021_LOUISA_REVS_SA","2021","58","LOUISA","6141865","4513","191363","5945989","1350","7342","1230324","3768227","28100","538250","55750","160180","11735512","2103970","0","0","13839482","5771899","19611381","POINT (-91.2596184 41.2185073)"
"2014_FRANKLIN_REVS_SA","2014","35","FRANKLIN","6158803","1250","238460","5919093","756","15425","1626537","4768253","13300","655132","93838","94185","13186519","1615104","0","12500","14814123","5034824","19848947","POINT (-93.262473 42.7325458)"
"2021_CASS_REVS_SA","2021","15","CASS","7757014","0","493400","7263614","1360","50200","2102623","4862154","17675","347755","344771","273861","15264013","4410154","0","0","19674167","9211700","28885867","POINT (-94.9278266 41.3314876)"
"2022_EMMET_REVS_SA","2022","32","EMMET","5234404","1600","307933","4924871","1600","7900","401341","3289423","15500","348055","61000","252149","9301839","1180449","0","0","10482288","5580505","16062793","POINT (-94.6784803 43.37802250000001)"
"2018_FAYETTE_REVS_SA","2018","33","FAYETTE","8548610","2950","489243","8056417","5200","59710","944897","8469529","24100","845430","80635","222051","18707969","2057706","425000","0","21190675","4846983","26037658","POINT (-91.8443207 42.8625919)"
"2011_MONROE_REVS_SA","2011","68","MONROE","4176311","0","106650","4069661","625","3000","713612","3058817","750","164490","76415","19101","8106471","914713","0","12000","9033184","1843813","10876997","POINT (-92.8689877 41.0297826)"
"2010_FAYETTE_REVS_SA","2010","33","FAYETTE","6582780","2400","376100","6204280","5500","57400","758786","6703880","12250","798240","89605","229223","14859164","1746216","0","0","16605380","2275312","18880692","POINT (-91.8443207 42.8625919)"
"2010_FRANKLIN_REVS_SA","2010","35","FRANKLIN","5351681","1500","188221","5161960","665","10150","545061","5344264","15800","589065","174155","115775","11956895","1577768","0","13000","13547663","3943245","17490908","POINT (-93.262473 42.7325458)"
"2022_TAMA_REVS_SA","2022","86","TAMA","9978850","0","0","9978850","2012","22604","1495321","8309666","22200","576624","149700","4262518","24819495","3037979","0","11500","27868974","9202343","37071317","POINT (-92.5325425 42.07981170000001)"
"2011_JASPER_REVS_SA","2011","50","JASPER","12347552","8950","497810","11840792","5990","100000","2112184","8691529","65626","862790","343955","469550","24492416","4812450","0","0","29304866","9776257","39081123","POINT (-93.053765 41.6860394)"
"2012_MONONA_REVS_SA","2012","67","MONONA","5016304","1201","208000","4807103","2400","25200","449987","5029246","11738","241610","181745","67485","10816514","1162623","0","0","11979137","4052788","16031925","POINT (-95.9599235 42.0516663)"
"2010_HUMBOLDT_REVS_SA","2010","46","HUMBOLDT","4195579","0","203447","3992132","1078","6100","516547","2842453","27260","222600","183025","181232","7972427","1207397","0","1000","9180824","4554409","13735233","POINT (-94.2071868 42.7764686)"
"2018_MILLS_REVS_SA","2018","65","MILLS","9119144","0","245555","8873589","0","55848","1200359","5155297","217800","430563","85654","70338","16089448","2440771","0","0","18530219","9018709","27548928","POINT (-95.62132670000001 41.0334523)"
"2011_MARION_REVS_SA","2011","63","MARION","9515097","0","354278","9160819","500","0","1302946","6639597","33310","1019600","213245","470682","18840699","1964704","750000","1000","21556403","11046813","32603216","POINT (-93.0994367 41.3344515)"
"2017_JONES_REVS_SA","2017","53","JONES","8072841","1080","532047","7539714","1050","44500","1014776","6622074","72622","603430","162752","342584","16403502","2082000","400000","0","18885502","7011620","25897122","POINT (-91.1314352 42.1212397)"
"2012_SCOTT_REVS_SA","2012","82","SCOTT","46163322","33707","930071","45199544","33707","790000","6189989","20901088","547320","4859826","348421","657971","79527866","10322530","0","60000","89910396","17418833","107329229","POINT (-90.6232428 41.6370978)"
"2010_MILLS_REVS_SA","2010","65","MILLS","5481400","0","198071","5283329","0","62200","815792","5427788","162875","404605","186170","113225","12455984","1500000","0","0","13955984","5889409","19845393","POINT (-95.62132670000001 41.0334523)"
"2015_POWESHIEK_REVS_SA","2015","79","POWESHIEK","6875506","565","268873","6606068","524","50050","1145890","4973508","17800","466769","214671","347230","13822510","2225353","0","0","16047863","6418370","22466233","POINT (-92.53146840000001 41.6864422)"
"2011_SCOTT_REVS_SA","2011","82","SCOTT","44242098","27977","940432","43273689","27977","825000","5737184","21050501","507870","4682772","360671","299123","76764787","8128064","0","76500","84969351","16200471","101169822","POINT (-90.6232428 41.6370978)"
"2016_WINNESHIEK_REVS_SA","2016","96","WINNESHIEK","8689346","220","463486","8225640","220","25350","1496985","8629506","17200","671600","137202","826005","20029708","2413993","0","15000","22458701","6973012","29431713","POINT (-91.8437074 43.2906746)"
"2012_WRIGHT_REVS_SA","2012","99","WRIGHT","6061748","200","211787","5849761","345","25805","594768","6455897","13100","486945","185169","144300","13756090","1683164","0","1000","15440254","7408364","22848618","POINT (-93.7351465 42.7331189)"
"2010_CHEROKEE_REVS_SA","2010","18","CHEROKEE","4306002","0","193350","4112652","75","0","989435","4231596","35160","233675","154320","53450","9810363","1371000","0","1000","11182363","4180099","15362462","POINT (-95.6238055 42.7356226)"
"2014_JACKSON_REVS_SA","2014","49","JACKSON","6036730","0","225736","5810994","854","50550","901309","4118249","28820","585530","295287","150825","11942418","940000","0","525","12882943","4339760","17222703","POINT (-90.5742294 42.1717426)"
"2011_JEFFERSON_REVS_SA","2011","51","JEFFERSON","5019281","2200","166000","4851081","930","57800","650557","3862629","14150","571437","172925","82750","10264259","994371","0","0","11258630","3284117","14542747","POINT (-91.9488774 41.0317596)"
"2013_POWESHIEK_REVS_SA","2013","79","POWESHIEK","6505208","500","188783","6315925","1161","55153","1090782","5275603","15600","441371","101443","366079","13663117","2281775","0","0","15944892","5329451","21274343","POINT (-92.53146840000001 41.6864422)"
"2017_HANCOCK_REVS_SA","2017","41","HANCOCK","5370345","0","170000","5200345","1200","30000","494307","4618544","17800","367175","132656","200850","11062877","2105483","0","0","13168360","6038410","19206770","POINT (-93.7342723 43.0818861)"
"2016_BOONE_REVS_SA","2016","8","BOONE","7783234","4025","412848","7366361","1330","80500","1364283","4999024","16100","1025670","107010","572000","15532278","3040042","0","10000","18582320","4915457","23497777","POINT (-93.931671 42.0365493)"
"2015_WAPELLO_REVS_SA","2015","90","WAPELLO","9462154","66100","468792","8927262","6085","141000","3641320","4322906","55100","776947","230873","396840","18498333","1557250","50138","34000","20139721","13584122","33723843","POINT (-92.4094499 41.03058450000001)"
"2021_MITCHELL_REVS_SA","2021","66","MITCHELL","5835060","0","279660","5555400","0","26000","4411693","4636047","7500","593410","266900","69100","15566050","1428508","0","1000","16995558","7359352","24354910","POINT (-92.7890315 43.3564124)"
"2018_DELAWARE_REVS_SA","2018","28","DELAWARE","9664211","4050","591085","9069076","450","30600","1221748","6372744","31300","478475","135385","184979","17524757","2550011","0","0","20074768","7776012","27850780","POINT (-91.3673502 42.471211)"
"2015_MONROE_REVS_SA","2015","68","MONROE","4854117","0","94250","4759867","645","5000","608085","3228211","2500","169555","53406","22165","8849434","1535157","4500000","5000","14889591","2868814","17758405","POINT (-92.8689877 41.0297826)"
"2019_CARROLL_REVS_SA","2019","14","CARROLL","6863952","0","565200","6298752","0","15000","1291428","5136092","51900","1845320","339746","451880","15430118","2902551","0","0","18332669","6980506","25313175","POINT (-94.8605593 42.0362382)"
"2019_STORY_REVS_SA","2019","85","STORY","25838588","0","1054456","24784132","3050","75000","3496431","8777341","78970","1867815","452025","516750","40051514","3093350","0","2000","43146864","17490523","60637387","POINT (-93.4650448 42.0362415)"
"2011_POTTAWATTAMIE_REVS_SA","2011","78","POTTAWATTAMIE","31292912","0","682079","30610833","12600","299500","7979738","19486205","325650","2320750","579911","3872505","65487692","6024404","0","0","71512096","24756324","96268420","POINT (-95.5423935 41.3366123)"
"2014_DELAWARE_REVS_SA","2014","28","DELAWARE","7412846","4025","327697","7081124","425","30700","1071700","5152585","22050","414020","166160","220506","14159270","2014145","0","0","16173415","4572175","20745590","POINT (-91.3673502 42.471211)"
"2020_CHEROKEE_REVS_SA","2020","18","CHEROKEE","6573876","0","348853","6225023","0","15350","952117","4158560","68100","374282","139177","176840","12109449","2161170","0","2050","14272669","9508258","23780927","POINT (-95.6238055 42.7356226)"
"2017_ADAMS_REVS_SA","2017","2","ADAMS","3135501","226","118384","3016891","399","0","688519","3025147","10138","365915","84895","22045","7213949","965883","0","0","8179832","2972882","11152714","POINT (-94.6991849 41.02898390000001)"
"2011_WAYNE_REVS_SA","2011","93","WAYNE","3077605","12600","122100","2942905","930","0","403952","3743150","4380","330000","56500","191694","7673511","475964","0","0","8149475","4190982","12340457","POINT (-93.3273639 40.73947020000001)"
"2014_BLACK HAWK_REVS_SA","2014","7","BLACK HAWK","32755358","42058","831499","31881801","10000","384500","3879252","12726605","501100","4181710","867438","1670122","56102528","2906004","0","0","59008532","19522688","78531220","POINT (-92.3088197 42.4700957)"
"2017_HAMILTON_REVS_SA","2017","40","HAMILTON","7072667","5000","423639","6644028","1500","30500","1270984","7466195","19475","1664105","262915","2560030","19919732","3010702","0","10100","22940534","18254276","41194810","POINT (-93.7068085 42.3837722)"
"2010_CLINTON_REVS_SA","2010","23","CLINTON","14895791","0","578989","14316802","44000","152000","2273291","10779817","92653","957355","275850","64775","28956543","745000","1844000","0","31545543","6487806","38033349","POINT (-90.5319724 41.8980358)"
"2010_HOWARD_REVS_SA","2010","45","HOWARD","3689251","0","203778","3485473","0","26254","571781","4021755","6600","464640","117082","631216","9324801","890112","0","30","10214943","2765355","12980298","POINT (-92.3171989 43.3567673)"
"2018_JOHNSON_REVS_SA","2018","52","JOHNSON","58131077","0","1950974","56180103","0","329000","792882","22862703","712875","4479720","301224","2372731","88031238","18422148","18162000","209500","124824886","24947558","149772444","POINT (-91.5880849 41.6715511)"
"2021_GREENE_REVS_SA","2021","37","GREENE","6277323","0","312950","5964373","0","20000","881697","5024838","61550","854950","106057","670555","13584020","1860100","0","0","15444120","6120090","21564210","POINT (-94.3968356 42.0362394)"
"2017_RINGGOLD_REVS_SA","2017","80","RINGGOLD","3288753","0","157200","3131553","1100","24100","422646","4136609","4200","576114","24200","30050","8350572","735825","0","0","9086397","4455275","13541672","POINT (-94.2439719 40.7352023)"
"2012_VAN BUREN_REVS_SA","2012","89","VAN BUREN","2527693","850","152600","2374243","850","30510","306181","4164907","16900","271640","114950","115750","7395931","624103","0","6100","8026134","2647856","10673990","POINT (-91.9499871 40.7532294)"
"2017_JEFFERSON_REVS_SA","2017","51","JEFFERSON","6195237","3250","305000","5886987","1000","58300","778531","3970579","27300","487940","74494","49401","11334532","1294281","2600000","0","15228813","3728966","18957779","POINT (-91.9488774 41.0317596)"
"2018_SIOUX_REVS_SA","2018","84","SIOUX","10197833","0","526450","9671383","650","55000","2080479","8006070","16500","873100","99649","763525","21566356","3004000","0","4500","24574856","14140260","38715116","POINT (-96.1778827 43.0826174)"
"2018_FRANKLIN_REVS_SA","2018","35","FRANKLIN","6285342","1000","362949","5921393","1000","31200","3676724","5989996","21180","604066","54685","81408","16381652","2460581","0","3000","18845233","16700807","35546040","POINT (-93.262473 42.7325458)"
"2015_SHELBY_REVS_SA","2015","83","SHELBY","5910997","0","249900","5661097","250","30000","648048","3946481","259300","302070","87205","159050","11093501","2651815","0","0","13745316","2688027","16433343","POINT (-95.31021130000002 41.6850926)"
"2017_CHICKASAW_REVS_SA","2017","19","CHICKASAW","5430968","0","315000","5115968","350","12000","821325","5295962","8450","658651","63295","142650","12118651","2151224","0","0","14269875","6106759","20376634","POINT (-92.3176637 43.06004140000001)"
"2015_STORY_REVS_SA","2015","85","STORY","22595047","0","589658","22005389","2800","53000","2792364","11863561","55730","2014760","207805","658635","39654044","2554012","0","8000","42216056","11564463","53780519","POINT (-93.4650448 42.0362415)"
"2012_WEBSTER_REVS_SA","2012","94","WEBSTER","11778155","0","352812","11425343","9780","115000","2811779","11053743","250290","804260","299469","104294","26873958","2913137","0","0","29787095","15591341","45378436","POINT (-94.18178810000002 42.4279662)"
"2019_MONROE_REVS_SA","2019","68","MONROE","5019090","0","251515","4767575","550","5250","541685","3432552","2500","161215","52503","16405","8980235","1467912","27000","5000","10480147","4108327","14588474","POINT (-92.8689877 41.0297826)"
"2010_LYON_REVS_SA","2010","60","LYON","4581293","0","235170","4346123","0","20050","531269","4858304","65636","680900","237530","37600","10777412","1200867","0","0","11978279","4591564","16569843","POINT (-96.2102924 43.380497)"
"2011_CLARKE_REVS_SA","2011","20","CLARKE","3846286","3300","144540","3698446","4795","46000","362302","3197403","54550","236280","42200","288960","7930936","581582","31532","0","8544050","1073238","9617288","POINT (-93.78515790000002 41.0290323)"
"2021_FREMONT_REVS_SA","2021","36","FREMONT","5837273","2770","293030","5541473","1160","24045","508887","8357183","20700","305045","103251","85811","14947555","1356480","104648","70000","16478683","4209558","20688241","POINT (-95.6046765 40.7455892)"
"2012_SIOUX_REVS_SA","2012","84","SIOUX","7775597","0","218000","7557597","0","25000","1748320","10327141","7250","704815","231179","623050","21224352","2438414","2500000","2750","26165516","11267501","37433017","POINT (-96.1778827 43.0826174)"
"2012_BLACK HAWK_REVS_SA","2012","7","BLACK HAWK","30679496","39636","889502","29750358","10000","384000","3953650","18265470","496400","4227588","1150809","1640758","59879033","2363170","1730000","0","63972203","19594197","83566400","POINT (-92.3088197 42.4700957)"
"2022_MONTGOMERY_REVS_SA","2022","69","MONTGOMERY","6730148","0","363870","6366278","0","26600","640722","4912389","13850","300260","67354","59068","12386521","1096000","0","0","13482521","4250485","17733006","POINT (-95.1563758 41.03014)"
"2022_GUTHRIE_REVS_SA","2022","39","GUTHRIE","8719152","0","235550","8483602","750","23000","1893908","5482505","25000","642443","147115","572300","17270623","2824267","400500","500","20495890","7748603","28244493","POINT (-94.501055 41.6837548)"
"2015_JEFFERSON_REVS_SA","2015","51","JEFFERSON","5656083","3700","283316","5369067","725","72400","711431","3452041","22950","477303","103048","87690","10296655","1209814","0","0","11506469","3753294","15259763","POINT (-91.9488774 41.0317596)"
"2012_MAHASKA_REVS_SA","2012","62","MAHASKA","6909243","0","127382","6781861","1900","10000","1494427","4680485","17450","568250","267294","47400","13869067","1767856","0","0","15636923","8611884","24248807","POINT (-92.6409094 41.3352035)"
"2010_DELAWARE_REVS_SA","2010","28","DELAWARE","6443945","4100","342438","6097407","500","30400","986823","5646385","11350","394970","190500","193046","13551381","1789702","0","0","15341083","1724381","17065464","POINT (-91.3673502 42.471211)"
"2014_CHEROKEE_REVS_SA","2014","18","CHEROKEE","5327537","0","174850","5152687","0","0","987527","4509328","49276","279625","71220","253256","11302919","1485000","0","2000","12789919","5370911","18160830","POINT (-95.6238055 42.7356226)"
"2016_IOWA_REVS_SA","2016","48","IOWA","7950685","7301","373271","7570113","9361","36250","2061362","5145408","32650","1706940","355846","184100","17102030","1315000","0","0","18417030","8092039","26509069","POINT (-92.065524 41.6863229)"
"2010_OSCEOLA_REVS_SA","2010","72","OSCEOLA","2654285","0","162417","2491868","870","0","489530","2812626","13050","263275","123258","33414","6227891","989337","0","0","7217228","1847161","9064389","POINT (-95.6236852 43.3785704)"
"2013_WINNEBAGO_REVS_SA","2013","95","WINNEBAGO","4335121","737","188190","4146194","1320","10600","1322350","3756052","14010","999375","259751","123585","10633237","1518471","261672","0","12413380","10152105","22565485","POINT (-93.7341955 43.37756780000001)"
"2021_JEFFERSON_REVS_SA","2021","51","JEFFERSON","7965305","5700","395000","7564605","1210","55400","816527","4055082","43000","3017900","104000","72174","15729898","1200000","0","0","16929898","10230300","27160198","POINT (-91.9488774 41.0317596)"
"2010_CALHOUN_REVS_SA","2010","13","CALHOUN","5601429","6000","230000","5365429","400","25000","192935","5055855","8550","1018260","228200","328947","12223576","1379232","0","0","13602808","3757202","17360010","POINT (-94.6404136 42.385184800000005)"
"2014_JASPER_REVS_SA","2014","50","JASPER","12614112","4450","439555","12170107","2270","100000","2314131","6530903","67200","825248","173090","441900","22624849","5419127","0","20000","28063976","9288039","37352015","POINT (-93.053765 41.6860394)"
"2019_HUMBOLDT_REVS_SA","2019","46","HUMBOLDT","5662023","0","332824","5329199","1304","28450","765685","3259968","7900","325750","120320","83800","9922376","1946980","0","4500","11873856","2905567","14779423","POINT (-94.2071868 42.7764686)"
"2013_TAMA_REVS_SA","2013","86","TAMA","7645417","0","383788","7261629","1214","11000","720673","6595396","11700","646019","217850","295895","15761376","2229846","0","0","17991222","6720521","24711743","POINT (-92.5325425 42.07981170000001)"
"2010_KOSSUTH_REVS_SA","2010","55","KOSSUTH","7680907","3000","407900","7270007","0","32100","997004","6845477","8550","607942","287734","177605","16226419","2855975","0","10000","19092394","6055479","25147873","POINT (-94.2067199 43.20413)"
"2015_POTTAWATTAMIE_REVS_SA","2015","78","POTTAWATTAMIE","41980652","0","751000","41229652","17100","297500","8616372","16244891","254450","2508200","133488","3287983","72589636","5910000","0","0","78499636","18042891","96542527","POINT (-95.5423935 41.3366123)"
"2013_CERRO GORDO_REVS_SA","2013","17","CERRO GORDO","15235754","11300","543250","14681204","2150","200000","2473481","8429597","1500","966175","319159","1318687","28391953","5330517","0","10000","33732470","12337133","46069603","POINT (-93.2608184 43.081557700000005)"
"2022_SIOUX_REVS_SA","2022","84","SIOUX","10166911","0","587960","9578951","295","57300","2246141","8348576","19500","964085","121299","1136565","22472712","4510791","0","4250","26987753","26297990","53285743","POINT (-96.1778827 43.0826174)"
"2016_CHEROKEE_REVS_SA","2016","18","CHEROKEE","5841862","0","292645","5549217","0","24225","983230","4759505","33383","342576","47220","128922","11868278","2127000","0","40225","14035503","5356239","19391742","POINT (-95.6238055 42.7356226)"
"2017_WINNEBAGO_REVS_SA","2017","95","WINNEBAGO","5692110","0","170410","5521700","370","5060","2847651","3746285","14886","1166761","261002","385830","13949545","1577737","0","0","15527282","16550941","32078223","POINT (-93.7341955 43.37756780000001)"
"2011_HUMBOLDT_REVS_SA","2011","46","HUMBOLDT","4469763","0","101720","4368043","1078","6000","504070","2953113","5900","217230","114000","151386","8320820","1311908","0","1000","9633728","4338150","13971878","POINT (-94.2071868 42.7764686)"
"2017_CLAY_REVS_SA","2017","21","CLAY","7973476","285","427534","7545657","180","33000","1267561","4671846","18119","535531","334941","604635","15011470","2502702","0","0","17514172","5778327","23292499","POINT (-95.1509194 43.0825804)"
"2015_APPANOOSE_REVS_SA","2015","4","APPANOOSE","3987216","0","433053","3554163","0","4500","1029723","3903340","3050","323715","20005","71160","8909656","754088","164000","0","9827744","6179798","16007542","POINT (-92.8686104 40.7431635)"
"2020_MONTGOMERY_REVS_SA","2020","69","MONTGOMERY","6912858","0","345106","6567752","0","36600","644633","3992856","12350","292305","51707","63244","11661447","1090000","0","0","12751447","3848605","16600052","POINT (-95.1563758 41.03014)"
"2021_CHICKASAW_REVS_SA","2021","19","CHICKASAW","6618169","0","308350","6309819","500","25000","909006","4878378","7600","1258961","40810","110750","13540824","1888863","3250000","0","18679687","8314625","26994312","POINT (-92.3176637 43.06004140000001)"
"2022_JOHNSON_REVS_SA","2022","52","JOHNSON","64787395","0","1949479","62837916","0","329000","951158","22820608","799150","4962242","783796","1016539","94500409","16876839","21918300","27334","133322882","35866214","169189096","POINT (-91.5880849 41.6715511)"
"2010_JASPER_REVS_SA","2010","50","JASPER","12331591","8950","506265","11816376","5975","100000","2036103","7314097","54600","905545","447040","427435","23107171","4358479","0","0","27465650","8513050","35978700","POINT (-93.053765 41.6860394)"
"2014_O'BRIEN_REVS_SA","2014","71","O'BRIEN","5870362","0","162400","5707962","0","17500","1218711","4116836","113000","423170","154504","93320","11845003","2112048","0","0","13957051","4810670","18767721","POINT (-95.6248784 43.0837527)"
"2021_APPANOOSE_REVS_SA","2021","4","APPANOOSE","4685093","0","392472","4292621","0","6000","1158052","4337437","3650","335885","100800","39310","10273755","830938","100775","0","11205468","7601405","18806873","POINT (-92.8686104 40.7431635)"
"2013_GUTHRIE_REVS_SA","2013","39","GUTHRIE","4331471","0","111500","4219971","1100","37000","642877","5217501","22550","520635","93856","412334","11167824","1424717","0","250","12592791","3740104","16332895","POINT (-94.501055 41.6837548)"
"2021_ADAMS_REVS_SA","2021","2","ADAMS","4451924","0","230497","4221427","0","0","846004","4267527","5430","538980","71695","45260","9996323","1167089","0","0","11163412","3708083","14871495","POINT (-94.6991849 41.02898390000001)"
"2012_GUTHRIE_REVS_SA","2012","39","GUTHRIE","3774250","0","115500","3658750","3550","36200","1048908","4474965","20400","455935","90198","416735","10205641","1375136","0","250","11581027","3970240","15551267","POINT (-94.501055 41.6837548)"
"2019_DES MOINES_REVS_SA","2019","29","DES MOINES","13766630","6328","842780","12917522","9400","119385","2619164","6664464","48335","935989","211560","303291","23829110","2294433","8991517","0","35115060","11833944","46949004","POINT (-91.1814707 40.9231829)"
"2018_CALHOUN_REVS_SA","2018","13","CALHOUN","6395948","0","329200","6066748","1000","28000","505657","4612653","9050","1101895","109010","512200","12946213","1671581","0","0","14617794","9734151","24351945","POINT (-94.6404136 42.385184800000005)"
"2011_SHELBY_REVS_SA","2011","83","SHELBY","4740274","0","262500","4477774","0","22000","794646","4854933","223484","271511","218074","111652","10974074","2545409","0","2000","13521483","4504876","18026359","POINT (-95.31021130000002 41.6850926)"
"2022_O'BRIEN_REVS_SA","2022","71","O'BRIEN","7243085","0","342600","6900485","100","20500","753990","5426752","114500","562025","180907","94250","14053509","4095309","0","0","18148818","7073446","25222264","POINT (-95.6248784 43.0837527)"
"2017_BUTLER_REVS_SA","2017","12","BUTLER","6585994","0","411500","6174494","1000","46000","1037890","5972021","34550","461217","300572","145465","14173209","2268860","0","0","16442069","5709532","22151601","POINT (-92.7901934 42.7315661)"
"2019_LINN_REVS_SA","2019","57","LINN","66288939","207078","2994200","63087661","18862","654500","8905759","26539829","1152075","7270223","858300","1321578","109808787","25890918","0","29930","135729635","44668273","180397908","POINT (-91.5989646 42.0789478)"
"2022_GREENE_REVS_SA","2022","37","GREENE","6541427","0","333325","6208102","0","10000","1236427","5131905","70225","846650","76307","477780","14057396","1865342","600000","130000","16652738","3598551","20251289","POINT (-94.3968356 42.0362394)"
"2013_KEOKUK_REVS_SA","2013","54","KEOKUK","4480526","0","140000","4340526","2600","40000","157686","3588732","29900","584230","393369","170200","9307243","1271500","0","0","10578743","5327130","15905873","POINT (-92.1786426 41.336465)"
"2015_HUMBOLDT_REVS_SA","2015","46","HUMBOLDT","5082101","0","203860","4878241","1030","20975","498435","2907669","5950","292450","64465","47124","8716339","1617597","0","1000","10334936","5272193","15607129","POINT (-94.2071868 42.7764686)"
"2010_TAYLOR_REVS_SA","2010","87","TAYLOR","2532899","6100","160045","2366754","910","4510","229201","3714353","18400","112380","62205","54093","6562806","677420","0","0","7240226","1596636","8836862","POINT (-94.6964148 40.73743240000001)"
"2011_MADISON_REVS_SA","2011","61","MADISON","4514614","0","154675","4359939","0","67933","873729","5188062","44100","782809","136068","45379","11498019","1363200","0","0","12861219","3708597","16569816","POINT (-94.01556190000001 41.33071420000001)"
"2016_POWESHIEK_REVS_SA","2016","79","POWESHIEK","6958664","0","254278","6704386","4663","50055","1228165","4393725","16575","482490","153305","191580","13224944","2264398","0","0","15489342","7112491","22601833","POINT (-92.53146840000001 41.6864422)"
"2017_OSCEOLA_REVS_SA","2017","72","OSCEOLA","4150445","0","250069","3900376","587","0","926421","3197077","21950","281985","60623","40950","8429969","1636429","0","0","10066398","4230902","14297300","POINT (-95.6236852 43.3785704)"
"2019_VAN BUREN_REVS_SA","2019","89","VAN BUREN","3026327","3400","207800","2815127","1700","36000","385943","3658415","17500","233360","137050","169860","7454955","840146","0","750","8295851","3642334","11938185","POINT (-91.9499871 40.7532294)"
"2016_BUENA VISTA_REVS_SA","2016","11","BUENA VISTA","9188449","45947","421840","8720662","1605","47050","1054239","5430471","65377","679953","75960","35395","16110712","2463318","0","75","18574105","7118142","25692247","POINT (-95.15114900000002 42.7354936)"
"2022_BLACK HAWK_REVS_SA","2022","7","BLACK HAWK","37576666","0","1770674","35805992","5000","270000","4348675","15045972","609200","4114940","471725","1341252","62012756","12416043","0","4553","74433352","42417626","116850978","POINT (-92.3088197 42.4700957)"
"2011_VAN BUREN_REVS_SA","2011","89","VAN BUREN","2323455","850","152600","2170005","850","30510","355984","3801241","10750","239930","123950","188650","6921870","593421","0","6100","7521391","2038468","9559859","POINT (-91.9499871 40.7532294)"
"2022_CLAYTON_REVS_SA","2022","22","CLAYTON","8983721","0","467690","8516031","450","20900","1122967","5164972","39700","460680","143760","110100","15579560","2000000","0","10000","17589560","9495720","27085280","POINT (-91.34143280000002 42.8447493)"
"2019_BUCHANAN_REVS_SA","2019","10","BUCHANAN","7167048","2205","447785","6717058","1915","56500","1069555","5947884","33707","626104","181805","108090","14742618","2718037","0","10000","17470655","5977122","23447777","POINT (-91.8378392 42.4707777)"
"2014_BUENA VISTA_REVS_SA","2014","11","BUENA VISTA","8816795","43600","305955","8467240","39500","47050","1038691","4623857","45375","690035","109235","342976","15403959","2338022","0","650","17742631","7818405","25561036","POINT (-95.15114900000002 42.7354936)"
"2011_PALO ALTO_REVS_SA","2011","74","PALO ALTO","5682168","6500","233900","5441768","210","6400","814182","4015798","11050","540360","403613","492141","11725522","1226782","0","0","12952304","12967380","25919684","POINT (-94.6781371 43.0820643)"
"2018_HAMILTON_REVS_SA","2018","40","HAMILTON","7638268","5000","438656","7194612","0","20900","1714961","6309939","19975","1810577","243558","1932416","19246938","3020561","0","8100","22275599","17310924","39586523","POINT (-93.7068085 42.3837722)"
"2011_CASS_REVS_SA","2011","15","CASS","5144942","450","206375","4938117","947","35610","921111","7182949","14700","301530","174390","506203","14075557","1925599","0","0","16001156","2109910","18111066","POINT (-94.9278266 41.3314876)"
"2016_UNION_REVS_SA","2016","88","UNION","5133220","0","202350","4930870","770","43100","1149525","4750495","32700","440962","52465","134840","11535727","901161","0","12000","12448888","2634520","15083408","POINT (-94.2423792 41.0277304)"
"2022_WINNEBAGO_REVS_SA","2022","95","WINNEBAGO","7226042","0","0","7226042","720","8020","3734583","4516546","18200","1164280","353180","815411","17836982","3088883","0","20000","20945865","8888567","29834432","POINT (-93.7341955 43.37756780000001)"
"2012_CLAYTON_REVS_SA","2012","22","CLAYTON","7443723","17267","327169","7099287","6167","68409","1296959","5664681","21660","476090","258090","512986","15404329","1400000","0","11000","16815329","6585046","23400375","POINT (-91.34143280000002 42.8447493)"
"2012_POLK_REVS_SA","2012","77","POLK","131319138","542870","2876296","127899972","50150","1580000","5536751","72839249","540900","11783124","3423512","2029307","225682965","27692808","3800000","153000","257328773","60344089","317672862","POINT (-93.5735335 41.6855048)"
"2017_WASHINGTON_REVS_SA","2017","92","WASHINGTON","9414688","0","617391","8797297","400","50280","1716997","6007487","54050","730065","157137","1590505","19104218","2841510","9412","1000","21956140","6775650","28731790","POINT (-91.7178676 41.335591)"
"2021_DES MOINES_REVS_SA","2021","29","DES MOINES","14677947","6620","884884","13786443","6620","125350","2584877","6329653","52385","957480","322856","305668","24471332","2540957","6856284","25000","33893573","11961169","45854742","POINT (-91.1814707 40.9231829)"
"2020_CLAYTON_REVS_SA","2020","22","CLAYTON","8686360","0","479675","8206685","470","33800","1455816","4943598","30225","472060","150420","715150","16008224","1750000","0","10000","17768224","6284281","24052505","POINT (-91.34143280000002 42.8447493)"
"2014_CRAWFORD_REVS_SA","2014","24","CRAWFORD","7618568","10968","270600","7337000","2300","47700","739232","6022101","4700","753790","112941","121919","15141683","2487502","0","170500","17799685","6847281","24646966","POINT (-95.3819678 42.0372125)"
"2010_SCOTT_REVS_SA","2010","82","SCOTT","37378887","19860","988307","36370720","19860","725000","6118154","20056693","504120","4599593","864732","366912","69625784","8310159","0","51777","77987720","15965592","93953312","POINT (-90.6232428 41.6370978)"
"2020_LUCAS_REVS_SA","2020","59","LUCAS","3566991","0","176340","3390651","1850","22000","618309","2992516","450","275160","28080","257264","7586280","741774","0","500","8328554","2643227","10971781","POINT (-93.3277207 41.0293738)"
"2017_HENRY_REVS_SA","2017","44","HENRY","6837722","0","361142","6476580","1607","53300","907743","4418471","54100","449880","66180","65100","12492961","1423913","0","0","13916874","6732109","20648983","POINT (-91.5445241 40.9879383)"
"2013_SAC_REVS_SA","2013","81","SAC","4953073","5000","74000","4874073","4800","35277","524554","5414931","15000","884438","48068","114800","11915941","1314077","0","119000","13349018","3150748","16499766","POINT (-95.1053946 42.3862604)"
"2020_ADAIR_REVS_SA","2020","1","ADAIR","5289345","0","252112","5037233","1000","30000","3338801","4709510","16400","213951","56630","34210","13437735","1491739","10000000","0","24929474","8016916","32946390","POINT (-94.4709413 41.3307464)"
"2020_BLACK HAWK_REVS_SA","2020","7","BLACK HAWK","37878845","0","1852000","36026845","5000","322000","4501823","14283259","777926","4253039","929125","1472888","62571905","10471171","0","7053","73050129","27649776","100699905","POINT (-92.3088197 42.4700957)"
"2012_FAYETTE_REVS_SA","2012","33","FAYETTE","7135666","2950","335242","6797474","5525","57410","804648","6821406","57250","907450","53105","266906","15771174","1702282","0","0","17473456","2512839","19986295","POINT (-91.8443207 42.8625919)"
"2013_MITCHELL_REVS_SA","2013","66","MITCHELL","4769250","0","189975","4579275","0","10200","1440536","3605213","6500","721100","147032","257019","10766875","1492118","6000000","1000","18259993","3323484","21583477","POINT (-92.7890315 43.3564124)"
"2014_LEE_REVS_SA","2014","56","LEE","10062164","0","414003","9648161","11014","111606","2153467","12557530","117850","1016542","260150","5171037","31047357","1550000","0","1000","32598357","7397597","39995954","POINT (-91.479264 40.6419764)"
"2010_POLK_REVS_SA","2010","77","POLK","121940768","505217","3024623","118410928","21100","1395000","5550123","70211706","541000","10479141","5796780","1968947","214374725","28261708","4000000","165000","246801433","48297684","295099117","POINT (-93.5735335 41.6855048)"
"2015_PAGE_REVS_SA","2015","73","PAGE","4672732","2700","237400","4432632","2200","31200","608637","3991327","38515","344034","79150","489232","10016927","1218904","0","30000","11265831","4273624","15539455","POINT (-95.1501747 40.7391444)"
"2010_BOONE_REVS_SA","2010","8","BOONE","6856802","11100","272152","6573550","8500","66200","1049601","7278432","14300","899900","429855","526200","16846538","2025354","580500","5000","19457392","4960491","24417883","POINT (-93.931671 42.0365493)"
"2021_LEE_REVS_SA","2021","56","LEE","13531005","0","970708","12560297","9923","142000","2929700","10752289","302100","1168062","577924","476508","28918803","2540141","0","0","31458944","9804950","41263894","POINT (-91.479264 40.6419764)"
"2012_IOWA_REVS_SA","2012","48","IOWA","6503314","6950","245810","6250554","4200","36250","1656995","4790523","29500","951050","340626","102730","14162428","1271725","702666","0","16136819","4889357","21026176","POINT (-92.065524 41.6863229)"
"2017_HOWARD_REVS_SA","2017","45","HOWARD","5204484","0","294992","4909492","1000","11100","2427556","3930710","12500","503022","135178","381937","12312495","1665965","0","0","13978460","4600606","18579066","POINT (-92.3171989 43.3567673)"
"2013_CLAYTON_REVS_SA","2013","22","CLAYTON","7573634","0","328395","7245239","4572","64152","1261917","6023558","26525","505130","206502","2120736","17458331","1400000","0","60000","18918331","6916165","25834496","POINT (-91.34143280000002 42.8447493)"
"2015_CASS_REVS_SA","2015","15","CASS","6576915","692","288441","6287782","905","46410","1035650","5789383","18725","361790","186816","551552","14279013","2330810","0","0","16609823","3578216","20188039","POINT (-94.9278266 41.3314876)"
"2018_VAN BUREN_REVS_SA","2018","89","VAN BUREN","2579772","3400","204800","2371572","1700","37500","395498","5150295","17300","236160","125050","136050","8471125","727267","0","750","9199142","3093055","12292197","POINT (-91.9499871 40.7532294)"
"2010_HAMILTON_REVS_SA","2010","40","HAMILTON","6309254","5000","242085","6062169","3900","30400","1097600","6569235","11675","1102100","227849","208220","15313148","2281862","2033566","0","19628576","4059863","23688439","POINT (-93.7068085 42.3837722)"
"2016_LEE_REVS_SA","2016","56","LEE","11089837","0","725479","10364358","13648","115010","2531366","10996833","117100","955852","223600","4869670","30187437","1676614","0","100","31864151","8440674","40304825","POINT (-91.479264 40.6419764)"
"2020_KEOKUK_REVS_SA","2020","54","KEOKUK","5936222","23050","326800","5586372","1600","42000","588351","4488390","49500","555970","179400","114000","11605583","2087395","0","0","13692978","4970378","18663356","POINT (-92.1786426 41.336465)"
"2014_GUTHRIE_REVS_SA","2014","39","GUTHRIE","4452710","0","117300","4335410","800","37000","592705","4612104","23550","461224","96941","450620","10610354","1477650","0","250","12088254","4249080","16337334","POINT (-94.501055 41.6837548)"
"2010_WRIGHT_REVS_SA","2010","99","WRIGHT","5215873","1500","236063","4978310","135","25530","489886","7236450","11050","497775","234488","222100","13695724","1385276","0","1000","15082000","3701284","18783284","POINT (-93.7351465 42.7331189)"
"2016_CLINTON_REVS_SA","2016","23","CLINTON","17063115","0","815429","16247686","6500","141600","2812220","8459485","34075","992165","167248","327850","29188829","1981506","0","0","31170335","6801438","37971773","POINT (-90.5319724 41.8980358)"
"2013_BLACK HAWK_REVS_SA","2013","7","BLACK HAWK","31693314","40774","846998","30805542","20000","364000","3899092","16370035","501900","4185202","930454","1631432","58707657","2653603","0","0","61361260","23039707","84400967","POINT (-92.3088197 42.4700957)"
"2021_FLOYD_REVS_SA","2021","34","FLOYD","8236720","0","389994","7846726","0","21020","1543461","5234730","29920","531830","436050","272823","15916560","1485917","0","0","17402477","12254630","29657107","POINT (-92.78900330000002 43.0599208)"
"2012_PALO ALTO_REVS_SA","2012","74","PALO ALTO","6120228","0","218580","5901648","210","10300","823894","3648414","10550","533820","298533","206163","11433532","1281252","0","0","12714784","6844814","19559598","POINT (-94.6781371 43.0820643)"
"2012_BUENA VISTA_REVS_SA","2012","11","BUENA VISTA","8081604","40445","265320","7775839","3980","43700","1027762","5017895","41625","620255","133352","36001","14700409","2087260","0","700","16788369","6040768","22829137","POINT (-95.15114900000002 42.7354936)"
"2016_BENTON_REVS_SA","2016","6","BENTON","8970741","0","599338","8371403","2200","56000","1095922","6228019","52350","762310","132437","317335","17017976","3970342","792738","2500","21783556","11238466","33022022","POINT (-92.0656912 42.0801864)"
"2018_OSCEOLA_REVS_SA","2018","72","OSCEOLA","4296822","0","248346","4048476","453","10000","816955","3199715","24100","306245","59783","67820","8533547","1762474","0","0","10296021","5745923","16041944","POINT (-95.6236852 43.3785704)"
"2021_TAYLOR_REVS_SA","2021","87","TAYLOR","4711383","3230","258692","4449461","715","0","302382","6206726","4766","317610","47260","24718","11353638","962162","0","0","12315800","3731532","16047332","POINT (-94.6964148 40.73743240000001)"
"2018_WRIGHT_REVS_SA","2018","99","WRIGHT","7159363","260","406052","6753051","3110","41420","923953","7103630","15650","567300","242938","398960","16050012","2123855","0","2500","18176367","5496409","23672776","POINT (-93.7351465 42.7331189)"
"2014_SCOTT_REVS_SA","2014","82","SCOTT","48415997","38493","977469","47400035","38493","780000","6311963","12980069","640470","5261265","363990","506082","74282367","10771749","0","180000","85234116","19862806","105096922","POINT (-90.6232428 41.6370978)"
"2018_CLARKE_REVS_SA","2018","20","CLARKE","4850864","2993","216899","4630972","960","45000","316547","3613752","17300","274845","26391","252866","9178633","699518","0","0","9878151","3243288","13121439","POINT (-93.78515790000002 41.0290323)"
"2013_WARREN_REVS_SA","2013","91","WARREN","12335843","5750","337487","11992606","4850","145000","435880","10599555","45300","1199175","79580","473727","24975673","2900000","0","7000","27882673","6837138","34719811","POINT (-93.5613594 41.3343735)"
"2014_WRIGHT_REVS_SA","2014","99","WRIGHT","6429180","770","259809","6168601","425","40855","769944","6983394","16625","515850","266766","218299","14980759","1801060","0","1000","16782819","5906385","22689204","POINT (-93.7351465 42.7331189)"
"2020_WARREN_REVS_SA","2020","91","WARREN","16587247","0","694400","15892847","2500","117800","1915212","8127535","100650","1440900","500000","227666","28325110","3435000","20400000","0","52160110","17225825","69385935","POINT (-93.5613594 41.3343735)"
"2016_GRUNDY_REVS_SA","2016","38","GRUNDY","5883580","0","253380","5630200","228","3000","627192","8256235","8650","314391","40775","218435","15099106","1622669","0","0","16721775","5260505","21982280","POINT (-92.7914177 42.4018651)"
"2017_MITCHELL_REVS_SA","2017","66","MITCHELL","5317572","0","218000","5099572","0","20000","4249366","4807169","7000","1039273","266555","107000","15595935","1290000","0","1000","16886935","2914994","19801929","POINT (-92.7890315 43.3564124)"
"2013_JACKSON_REVS_SA","2013","49","JACKSON","5561509","0","237606","5323903","782","50320","877220","5765587","32020","547785","212997","254465","13065079","990000","0","25","14055104","4616478","18671582","POINT (-90.5742294 42.1717426)"
"2018_MONONA_REVS_SA","2018","67","MONONA","6053920","2098","259330","5792492","30","15300","485272","5905789","7100","218092","169350","250086","12843511","1676003","0","0","14519514","6167350","20686864","POINT (-95.9599235 42.0516663)"
"2013_O'BRIEN_REVS_SA","2013","71","O'BRIEN","5669890","0","205700","5464190","280","13000","1251376","5353798","70000","383345","134144","71875","12742008","1851914","0","0","14593922","4809629","19403551","POINT (-95.6248784 43.0837527)"
"2015_LOUISA_REVS_SA","2015","58","LOUISA","4918630","13800","148547","4756283","4000","41000","1338236","9788410","18309","501835","26660","31200","16505933","1985832","5250","0","18497015","5614722","24111737","POINT (-91.2596184 41.2185073)"
"2015_HANCOCK_REVS_SA","2015","41","HANCOCK","5173480","0","133000","5040480","975","32000","504361","3735463","18000","334593","210125","181075","10057072","2245000","0","0","12302072","4442734","16744806","POINT (-93.7342723 43.0818861)"
"2018_DALLAS_REVS_SA","2018","25","DALLAS","24026382","0","481700","23544682","0","153500","457820","9679527","203750","2852525","344034","1282720","38518558","6170229","0","355000","45043787","22366277","67410064","POINT (-94.0397374 41.6848862)"
"2011_AUDUBON_REVS_SA","2011","5","AUDUBON","3357494","0","125000","3232494","0","0","330327","3004351","2500","164755","38522","13750","6786699","699102","0","0","7485801","2777452","10263253","POINT (-94.9058222 41.6845893)"
"2016_CEDAR_REVS_SA","2016","16","CEDAR","8472641","4100","357860","8110681","2300","46510","899518","5561810","27760","1131370","171444","101376","16052769","2165990","25000","8400","18252159","4076304","22328463","POINT (-91.1324125 41.7723207)"
"2013_DECATUR_REVS_SA","2013","27","DECATUR","2398542","0","1","2398541","3650","38025","270122","4685133","7600","284571","11937","258994","7958573","496984","146000","0","8601557","2597362","11198919","POINT (-93.7862815 40.7376827)"
"2016_ADAIR_REVS_SA","2016","1","ADAIR","4782569","0","219096","4563473","0","27000","2329414","4003785","13700","170330","43595","39745","11191042","1731043","0","10000","12932085","10438688","23370773","POINT (-94.4709413 41.3307464)"
"2011_HARDIN_REVS_SA","2011","42","HARDIN","6313526","0","198200","6115326","1000","33450","997555","7518072","17250","419940","150100","148725","15401418","3142609","650500","0","19194527","6281956","25476483","POINT (-93.2404025 42.3838803)"
"2018_BOONE_REVS_SA","2018","8","BOONE","7950976","2950","411745","7536281","1300","66000","1425349","5831582","23250","1025520","132760","1384100","17426142","3151700","0","15000","20592842","5709215","26302057","POINT (-93.931671 42.0365493)"
"2012_CEDAR_REVS_SA","2012","16","CEDAR","6796913","5000","295149","6496764","3850","46500","775000","6023096","40850","963078","168796","56605","14574539","1831407","30000","8401","16444347","4484143","20928490","POINT (-91.1324125 41.7723207)"
"2021_PALO ALTO_REVS_SA","2021","74","PALO ALTO","7138084","0","325200","6812884","0","12000","1787795","4367062","26350","668862","94217","293101","14062271","2758118","0","0","16820389","7706925","24527314","POINT (-94.6781371 43.0820643)"
"2017_FLOYD_REVS_SA","2017","34","FLOYD","5929436","0","343594","5585842","0","13300","1562526","5609244","25000","470160","71540","291519","13629131","1234741","0","0","14863872","7417204","22281076","POINT (-92.78900330000002 43.0599208)"
"2016_DELAWARE_REVS_SA","2016","28","DELAWARE","8694042","4050","538925","8151067","450","30700","1207603","6029079","23050","444040","136445","220534","16242968","2219826","0","0","18462794","6764196","25226990","POINT (-91.3673502 42.471211)"
"2010_WASHINGTON_REVS_SA","2010","92","WASHINGTON","7435421","0","357447","7077974","1498","62000","3458822","7288384","53830","671485","150523","252170","19016686","1793328","0","0","20810014","4652804","25462818","POINT (-91.7178676 41.335591)"
"2014_UNION_REVS_SA","2014","88","UNION","5292510","0","192122","5100388","600","20282","1128668","3312233","9873","430730","61334","188106","10252214","856304","0","10000","11118518","1916634","13035152","POINT (-94.2423792 41.0277304)"
"2018_LINN_REVS_SA","2018","57","LINN","66527348","208191","3169500","63149657","14100","645000","8745661","30060128","1087804","6960108","722350","1238654","112623462","18282480","0","27750","130933692","38617605","169551297","POINT (-91.5989646 42.0789478)"
"2017_BOONE_REVS_SA","2017","8","BOONE","7985694","3150","402045","7580499","1300","65000","1402630","5472333","17100","1012020","97610","556675","16205167","3084961","0","10000","19300128","4727118","24027246","POINT (-93.931671 42.0365493)"
"2015_DAVIS_REVS_SA","2015","26","DAVIS","3162391","0","202839","2959552","759","38589","478511","3093619","1298","188140","109327","201891","7071686","780146","0","0","7851832","2651518","10503350","POINT (-92.4097173 40.7476891)"
"2010_MONONA_REVS_SA","2010","67","MONONA","4572786","850","247860","4324076","2135","24200","386894","6441295","10200","231955","193810","44930","11659495","1079414","0","0","12738909","3965031","16703940","POINT (-95.9599235 42.0516663)"
"2012_HARRISON_REVS_SA","2012","43","HARRISON","7141313","6500","275000","6859813","2850","51500","647642","5308945","32625","536375","265960","608365","14314075","1562076","0","0","15876151","7864711","23740862","POINT (-95.8169209 41.6828528)"
"2012_KEOKUK_REVS_SA","2012","54","KEOKUK","4184156","0","140000","4044156","4250","38000","148485","3267609","29900","578967","328390","138750","8578507","1200000","0","0","9778507","6484192","16262699","POINT (-92.1786426 41.336465)"
"2020_HAMILTON_REVS_SA","2020","40","HAMILTON","8653115","5000","473713","8174402","0","31600","1499621","6197784","20075","2522946","488911","4575105","23510444","4434451","0","6100","27950995","4319260","32270255","POINT (-93.7068085 42.3837722)"
"2019_AUDUBON_REVS_SA","2019","5","AUDUBON","4344393","0","211000","4133393","0","0","662819","3525736","10000","209460","20528","1030","8562966","2239526","0","0","10802492","5383752","16186244","POINT (-94.9058222 41.6845893)"
"2021_MADISON_REVS_SA","2021","61","MADISON","8117488","0","355153","7762335","33","67255","1165237","6577272","80421","1101290","124013","83710","16961566","2427168","0","2000","19390734","4672697","24063431","POINT (-94.01556190000001 41.33071420000001)"
"2019_PALO ALTO_REVS_SA","2019","74","PALO ALTO","6928006","3750","351305","6572951","0","15000","1754466","4245875","16350","667067","51200","610231","13933140","2624926","0","0","16558066","11814273","28372339","POINT (-94.6781371 43.0820643)"
"2016_FAYETTE_REVS_SA","2016","33","FAYETTE","7796395","2950","460539","7332906","5050","59210","803373","5889609","22750","887082","66150","447396","15513526","1893954","350000","10000","17767480","4350576","22118056","POINT (-91.8443207 42.8625919)"
"2019_DALLAS_REVS_SA","2019","25","DALLAS","25979340","0","497200","25482140","0","143250","3608908","7123891","210250","2748325","486884","2166735","41970383","6509915","0","150000","48630298","40862846","89493144","POINT (-94.0397374 41.6848862)"
"2017_POLK_REVS_SA","2017","77","POLK","156347407","643547","7002405","148701455","800","1307000","5854489","49928184","973800","13365530","3078610","2513940","225723808","35716804","100000","375000","261915612","124204784","386120396","POINT (-93.5735335 41.6855048)"
"2019_JONES_REVS_SA","2019","53","JONES","8113380","950","539745","7572685","720","42050","1030437","7341739","62136","616955","204941","426918","17298581","2262427","450000","25000","20036008","8518644","28554652","POINT (-91.1314352 42.1212397)"
"2020_FAYETTE_REVS_SA","2020","33","FAYETTE","8815694","2900","584273","8228521","5000","60185","972525","7517107","26125","857002","99633","286315","18052413","2416705","0","0","20469118","6633120","27102238","POINT (-91.8443207 42.8625919)"
"2016_PLYMOUTH_REVS_SA","2016","75","PLYMOUTH","8882078","500","433064","8448514","1000","68300","2521125","6610964","24750","1105750","146475","1024790","19951668","4038775","100000","0","24090443","7156404","31246847","POINT (-96.2140431 42.7378346)"
"2011_LINN_REVS_SA","2011","57","LINN","52396756","165823","1370245","50860688","39950","565000","7834960","51022188","795275","6619815","688115","774040","119200031","14729071","0","28150","133957252","20576315","154533567","POINT (-91.5989646 42.0789478)"
"2012_ADAIR_REVS_SA","2012","1","ADAIR","3711372","8797","161375","3541200","1150","27000","734058","4223392","14100","175445","99006","9850","8825201","2034625","0","0","10859826","7277152","18136978","POINT (-94.4709413 41.3307464)"
"2021_VAN BUREN_REVS_SA","2021","89","VAN BUREN","3377788","3400","199350","3175038","750","35500","382916","3812380","16150","227350","152025","109310","7911419","980000","0","65550","8956969","4521041","13478010","POINT (-91.9499871 40.7532294)"
"2011_BUCHANAN_REVS_SA","2011","10","BUCHANAN","7115003","35627","329239","6750137","2650","55000","1029202","7233264","13550","549965","185454","67275","15886497","2072477","0","0","17958974","4366410","22325384","POINT (-91.8378392 42.4707777)"
"2013_FLOYD_REVS_SA","2013","34","FLOYD","6278430","0","230635","6047795","0","25200","1204905","4225589","20000","450855","76680","320174","12371198","1028517","0","0","13399715","7368791","20768506","POINT (-92.78900330000002 43.0599208)"
"2014_MONONA_REVS_SA","2014","67","MONONA","5097336","2728","249600","4845008","3450","23600","510203","3775708","10600","241755","232381","28560","9671265","1488139","0","0","11159404","5317691","16477095","POINT (-95.9599235 42.0516663)"
"2019_HARDIN_REVS_SA","2019","42","HARDIN","8544431","0","455310","8089121","2160","0","1319230","6663239","24700","452190","182050","1487478","18220168","2206398","0","0","20426566","8522043","28948609","POINT (-93.2404025 42.3838803)"
"2020_OSCEOLA_REVS_SA","2020","72","OSCEOLA","4805563","246","258007","4547310","637","10000","460461","3196993","29400","320240","130019","49620","8744680","1379106","0","0","10123786","7605127","17728913","POINT (-95.6236852 43.3785704)"
"2021_CRAWFORD_REVS_SA","2021","24","CRAWFORD","9577416","9431","455450","9112535","700","30300","797976","7303718","7000","1099697","176250","143863","18672039","3712500","0","309250","22693789","8423565","31117354","POINT (-95.3819678 42.0372125)"
"2019_CLAYTON_REVS_SA","2019","22","CLAYTON","8408223","0","543948","7864275","620","46466","1476887","6051406","29900","454710","154837","183980","16263081","1750000","0","10500","18023581","7027267","25050848","POINT (-91.34143280000002 42.8447493)"
"2016_WASHINGTON_REVS_SA","2016","92","WASHINGTON","9049949","0","469152","8580797","299","67000","1713778","5498175","54750","713425","152997","377450","17158671","2603750","8889","1000","19772310","6939399","26711709","POINT (-91.7178676 41.335591)"
"2015_DECATUR_REVS_SA","2015","27","DECATUR","2707865","0","10","2707855","0","33700","300007","4130613","8388","302100","6000","85522","7574185","465000","0","0","8039185","2395614","10434799","POINT (-93.7862815 40.7376827)"
"2021_SHELBY_REVS_SA","2021","83","SHELBY","6735416","0","292400","6443016","300","25000","752491","4443747","24550","301135","78024","373581","12441844","3901212","0","0","16343056","3987267","20330323","POINT (-95.31021130000002 41.6850926)"
"2019_WAYNE_REVS_SA","2019","93","WAYNE","3804767","0","155000","3649767","0","20796","418566","4336918","6600","458321","65009","103826","9059803","659807","0","0","9719610","5392003","15111613","POINT (-93.3273639 40.73947020000001)"
"2022_BUENA VISTA_REVS_SA","2022","11","BUENA VISTA","11515685","59200","593926","10862559","975","22600","1138341","6603595","95175","1001775","151473","146075","20022568","3003888","0","0","23026456","9838698","32865154","POINT (-95.15114900000002 42.7354936)"
"2011_EMMET_REVS_SA","2011","32","EMMET","4228335","250","150700","4077385","650","15750","337763","2780085","9500","314463","115260","129489","7780345","730420","1000","500","8512265","2076247","10588512","POINT (-94.6784803 43.37802250000001)"
"2014_APPANOOSE_REVS_SA","2014","4","APPANOOSE","3976544","0","210019","3766525","2200","5500","1031844","4210366","3050","280041","20010","70992","9390528","737215","140745","0","10268488","6132069","16400557","POINT (-92.8686104 40.7431635)"
"2019_MONTGOMERY_REVS_SA","2019","69","MONTGOMERY","6315427","0","328687","5986740","2350","36600","637065","5366454","12350","282180","51698","73300","12448737","1010000","0","22824","13481561","6429659","19911220","POINT (-95.1563758 41.03014)"
"2022_DAVIS_REVS_SA","2022","26","DAVIS","4713729","0","362965","4350764","0","28337","930013","5185687","0","365724","159480","558501","11578506","1144414","0","0","12722920","1695239","14418159","POINT (-92.4097173 40.7476891)"
"2017_POCAHONTAS_REVS_SA","2017","76","POCAHONTAS","6590588","0","240202","6350386","500","17000","435218","4032115","11400","423130","130980","120654","11521383","1225000","0","15000","12761383","7463487","20224870","POINT (-94.67874660000001 42.73413510000001)"
"2018_FREMONT_REVS_SA","2018","36","FREMONT","5393016","1060","291671","5100285","1060","24045","742716","3989274","19700","284045","84567","68720","10314412","1379215","104648","24000","11822275","4397332","16219607","POINT (-95.6046765 40.7455892)"
"2016_HARRISON_REVS_SA","2016","43","HARRISON","8230972","3500","391264","7836208","5100","51500","694810","4589114","32500","648330","125140","205460","14188162","2011500","0","0","16199662","9765210","25964872","POINT (-95.8169209 41.6828528)"
"2020_KOSSUTH_REVS_SA","2020","55","KOSSUTH","9426594","0","495461","8931133","0","31000","1560628","7279628","19400","618500","169586","69250","18679125","3165713","20900","30000","21895738","9066152","30961890","POINT (-94.2067199 43.20413)"
"2017_ALLAMAKEE_REVS_SA","2017","3","ALLAMAKEE","6845411","0","432638","6412773","0","0","1031621","7029523","22799","318580","129764","59150","15004210","1843443","105000","5500","16958153","9124083","26082236","POINT (-91.3780923 43.2842838)"
"2022_LOUISA_REVS_SA","2022","58","LOUISA","6136122","5196","313668","5817258","3189","19613","1100917","3564997","42010","552600","45750","193824","11340158","1727969","0","0","13068127","3242270","16310397","POINT (-91.2596184 41.2185073)"
"2020_POLK_REVS_SA","2020","77","POLK","186270558","764421","9257294","176248843","19350","1142000","6248612","53851122","1261450","16705048","7818735","2037211","265332371","35417384","0","248000","300997755","112102419","413100174","POINT (-93.5735335 41.6855048)"
"2012_SAC_REVS_SA","2012","81","SAC","4736758","0","100000","4636758","1460","29695","528254","4439688","16500","862026","33308","15600","10563289","1250669","0","110000","11923958","3051629","14975587","POINT (-95.1053946 42.3862604)"
"2018_POLK_REVS_SA","2018","77","POLK","162436919","667031","7660061","154109827","2400","1130000","5588944","44642678","1115130","14566083","3740756","2661920","227557738","27868186","27565000","121500","283112424","100257790","383370214","POINT (-93.5735335 41.6855048)"
"2017_UNION_REVS_SA","2017","88","UNION","5049379","0","239900","4809479","2280","58050","1137685","6940668","32650","433099","58210","200497","13672618","927427","0","20000","14620045","2987302","17607347","POINT (-94.2423792 41.0277304)"
"2014_LYON_REVS_SA","2014","60","LYON","5726525","0","251610","5474915","0","19070","1924935","4576318","74725","755680","151590","180289","13157522","2413849","0","2000","15573371","5222156","20795527","POINT (-96.2102924 43.380497)"
"2018_WASHINGTON_REVS_SA","2018","92","WASHINGTON","9989919","0","651589","9338330","500","50300","1808827","6269565","79260","767365","171741","1531201","20017089","2781656","6796","1000","22806541","5932549","28739090","POINT (-91.7178676 41.335591)"
"2020_DAVIS_REVS_SA","2020","26","DAVIS","4762137","0","323404","4438733","984","39852","667982","5092632","1167","343944","276381","513010","11374685","951090","0","0","12325775","2623220","14948995","POINT (-92.4097173 40.7476891)"
"2021_UNION_REVS_SA","2021","88","UNION","6117567","0","244530","5873037","2800","20750","856953","3381452","17775","449709","60310","747000","11409786","962119","0","0","12371905","5615703","17987608","POINT (-94.2423792 41.0277304)"
"2012_DAVIS_REVS_SA","2012","26","DAVIS","2732632","0","154178","2578454","912","36845","440212","2536009","974","175495","127754","429005","6325660","612436","600000","11500","7549596","3058291","10607887","POINT (-92.4097173 40.7476891)"
"2016_CASS_REVS_SA","2016","15","CASS","6667491","440","285839","6381212","1005","47300","1020281","8104277","31140","357115","178698","379064","16500092","3523142","0","0","20023234","3358274","23381508","POINT (-94.9278266 41.3314876)"
"2013_WORTH_REVS_SA","2013","98","WORTH","4166214","497","84884","4080833","6892","24326","2397757","4945813","20410","281750","204936","456103","12418820","1040630","4000000","1054","17460504","10378228","27838732","POINT (-93.2608476 43.3773984)"
"2019_WINNESHIEK_REVS_SA","2019","96","WINNESHIEK","9680690","200","609031","9071459","200","50350","1603633","8970293","28550","811550","172405","1147341","21855781","2742101","0","15000","24612882","9015714","33628596","POINT (-91.8437074 43.2906746)"
"2013_BUCHANAN_REVS_SA","2013","10","BUCHANAN","7460791","35765","276512","7148514","2800","55000","1021822","6092485","29721","618790","213451","100600","15283183","2332827","0","42500","17658510","6563930","24222440","POINT (-91.8378392 42.4707777)"
"2011_GREENE_REVS_SA","2011","37","GREENE","5033309","0","235375","4797934","0","5000","418118","3875097","9225","359425","36793","368800","9870392","1158500","0","0","11028892","2654946","13683838","POINT (-94.3968356 42.0362394)"
"2021_DALLAS_REVS_SA","2021","25","DALLAS","26387124","0","561000","25826124","0","158000","4445920","7898662","180750","2898625","778066","1376100","43562247","12674529","0","50000","56286776","25174620","81461396","POINT (-94.0397374 41.6848862)"
"2015_MONTGOMERY_REVS_SA","2015","69","MONTGOMERY","5573539","2100","217818","5353621","1010","45000","564326","2909865","7250","284081","59930","88900","9313983","780000","0","0","10093983","6095070","16189053","POINT (-95.1563758 41.03014)"
"2020_BUENA VISTA_REVS_SA","2020","11","BUENA VISTA","10032577","50163","544526","9437888","640","17600","1136281","6154924","103504","726795","182785","250875","18011292","2832396","0","0","20843688","6834041","27677729","POINT (-95.15114900000002 42.7354936)"
"2013_ALLAMAKEE_REVS_SA","2013","3","ALLAMAKEE","5607793","0","207834","5399959","0","0","837430","10102373","19179","303115","166701","304335","17133092","1530014","0","5500","18668606","3516047","22184653","POINT (-91.3780923 43.2842838)"
"2012_DES MOINES_REVS_SA","2012","29","DES MOINES","12191559","9190","305398","11876971","6747","142900","2513293","6380967","46540","1002700","205035","329150","22504303","1798977","0","0","24303280","5648550","29951830","POINT (-91.1814707 40.9231829)"
"2010_APPANOOSE_REVS_SA","2010","4","APPANOOSE","3643881","0","222879","3421002","1800","4000","1030231","4794696","650","269320","100300","135150","9757149","499940","199000","0","10456089","5073541","15529630","POINT (-92.8686104 40.7431635)"
"2022_MARION_REVS_SA","2022","63","MARION","14874547","0","800127","14074420","500","53000","1554729","8511377","46050","1427475","95960","217264","25980775","3016449","10000000","65000","39062224","16287059","55349283","POINT (-93.0994367 41.3344515)"
"2012_MUSCATINE_REVS_SA","2012","70","MUSCATINE","14407838","0","406600","14001238","13100","135500","4865934","9145528","73200","940375","397200","128400","29700475","1459100","500000","34000","31693575","4052876","35746451","POINT (-91.1127562 41.4839221)"
"2018_LYON_REVS_SA","2018","60","LYON","6552929","0","373225","6179704","0","25070","1981497","5584016","72550","876680","159053","161440","15040010","3169192","4275000","40000","22524202","6724230","29248432","POINT (-96.2102924 43.380497)"
"2021_CARROLL_REVS_SA","2021","14","CARROLL","9306255","0","541000","8765255","0","12000","1439307","5307146","55500","1918620","375258","553280","18426366","3849462","0","0","22275828","15379865","37655693","POINT (-94.8605593 42.0362382)"
"2015_BUENA VISTA_REVS_SA","2015","11","BUENA VISTA","8802365","44013","336653","8421699","1625","46950","1018972","5132614","66082","681360","112830","26595","15508727","2397790","0","650","17907167","7355375","25262542","POINT (-95.15114900000002 42.7354936)"
"2014_HARRISON_REVS_SA","2014","43","HARRISON","7870757","6000","319100","7545657","11100","55500","689718","4547665","32575","608430","122260","199565","13812470","1861000","0","0","15673470","8756909","24430379","POINT (-95.8169209 41.6828528)"
"2014_FREMONT_REVS_SA","2014","36","FREMONT","4189732","0","194015","3995717","1650","24045","1022910","4383467","26250","292893","71662","74749","9893343","1057558","107948","24000","11082849","3935549","15018398","POINT (-95.6046765 40.7455892)"
"2012_HENRY_REVS_SA","2012","44","HENRY","6734233","0","263546","6470687","3467","53300","863782","3911635","41000","1637750","79613","48000","13109234","1081504","0","0","14190738","3620672","17811410","POINT (-91.5445241 40.9879383)"
"2010_SAC_REVS_SA","2010","81","SAC","4225568","4756","100","4220712","509","27535","387289","4019938","18500","861723","146825","15500","9698531","1079071","0","0","10777602","3004784","13782386","POINT (-95.1053946 42.3862604)"
"2016_LYON_REVS_SA","2016","60","LYON","6588704","0","291820","6296884","0","23030","1869252","6881454","70550","836435","151419","196493","16325517","2567513","0","30000","18923030","6221603","25144633","POINT (-96.2102924 43.380497)"
"2019_EMMET_REVS_SA","2019","32","EMMET","4938866","170","300370","4638326","170","8150","394338","3279131","12300","338039","41470","239476","8951400","1046210","0","0","9997610","5135794","15133404","POINT (-94.6784803 43.37802250000001)"
"2011_MONTGOMERY_REVS_SA","2011","69","MONTGOMERY","4312801","2100","202236","4108465","1019","15800","513406","4269105","8200","395181","62765","47350","9421291","989784","15840","0","10426915","2429042","12855957","POINT (-95.1563758 41.03014)"
"2010_FREMONT_REVS_SA","2010","36","FREMONT","3225062","1650","177020","3046392","1650","24045","1016707","3995953","14555","257855","138615","319081","8814853","855661","144740","24000","9839254","4046350","13885604","POINT (-95.6046765 40.7455892)"
"2016_MILLS_REVS_SA","2016","65","MILLS","7807865","0","245555","7562310","0","57606","941312","4742535","193850","492569","99669","132399","14222250","2483785","0","8000","16714035","4621159","21335194","POINT (-95.62132670000001 41.0334523)"
"2014_POTTAWATTAMIE_REVS_SA","2014","78","POTTAWATTAMIE","35474538","0","688000","34786538","13600","304500","8352203","27836925","315350","2527000","438669","3048146","77622931","6050000","0","0","83672931","14089337","97762268","POINT (-95.5423935 41.3366123)"
"2020_TAYLOR_REVS_SA","2020","87","TAYLOR","4600465","3230","258692","4338543","715","0","306953","4842918","4766","278750","40710","24218","9837573","943568","0","0","10781141","3656832","14437973","POINT (-94.6964148 40.73743240000001)"
"2017_DICKINSON_REVS_SA","2017","30","DICKINSON","9178296","1280","242266","8934750","1280","44200","2109180","5177541","62850","625680","233485","255075","17444041","3788277","0","1000","21233318","12318098","33551416","POINT (-95.1508301 43.3779848)"
"2020_HOWARD_REVS_SA","2020","45","HOWARD","5863725","0","302810","5560915","950","11100","2344597","4978926","19000","455789","269230","123007","13763514","2038742","0","0","15802256","5622421","21424677","POINT (-92.3171989 43.3567673)"
"2014_WINNEBAGO_REVS_SA","2014","95","WINNEBAGO","4165639","737","188190","3976712","1000","10550","685133","3283348","15556","1054056","260596","118915","9405866","1566462","300000","0","11272328","7428254","18700582","POINT (-93.7341955 43.37756780000001)"
"2016_SCOTT_REVS_SA","2016","82","SCOTT","47395718","20603","1427968","45947147","20603","800000","6690708","13935767","633670","5479153","181221","753100","74441369","11247067","0","351000","86039436","28743936","114783372","POINT (-90.6232428 41.6370978)"
"2014_DUBUQUE_REVS_SA","2014","31","DUBUQUE","28594023","14120","845707","27734196","14120","229250","4785324","16038754","83250","3972797","251267","224393","53333351","6482787","680000","0","60496138","19087436","79583574","POINT (-90.8824564 42.468832)"
"2021_POTTAWATTAMIE_REVS_SA","2021","78","POTTAWATTAMIE","44930425","0","1720400","43210025","3000","317000","8038803","20421592","282300","2780903","644505","5943000","81641128","12625000","0","600000","94866128","46422291","141288419","POINT (-95.5423935 41.3366123)"
"2022_CEDAR_REVS_SA","2022","16","CEDAR","10643752","0","522724","10121028","400","42200","1150076","6566568","34689","1250790","164902","128327","19458980","2778821","20000","1000","22258801","17735686","39994487","POINT (-91.1324125 41.7723207)"
"2022_CLAY_REVS_SA","2022","21","CLAY","8843518","0","466069","8377449","495","20750","1398195","5261944","15500","650033","368383","171400","16264149","2225283","0","0","18489432","18993748","37483180","POINT (-95.1509194 43.0825804)"
"2015_WINNEBAGO_REVS_SA","2015","95","WINNEBAGO","4463835","737","146000","4317098","1100","5071","2082773","3834481","15296","995518","51033","224360","11526730","1603228","0","0","13129958","2966434","16096392","POINT (-93.7341955 43.37756780000001)"
"2011_MARSHALL_REVS_SA","2011","64","MARSHALL","11548449","0","474267","11074182","1700","12000","1937904","8269411","46775","717572","374918","346610","22781072","2045550","750000","4000","25580622","6589520","32170142","POINT (-92.9987706 42.0358499)"
"2015_GREENE_REVS_SA","2015","37","GREENE","5005818","0","301575","4704243","0","5000","546295","3365778","55725","351700","55306","366940","9450987","1190000","0","0","10640987","3560909","14201896","POINT (-94.3968356 42.0362394)"
"2019_KEOKUK_REVS_SA","2019","54","KEOKUK","5047555","90000","294100","4663455","1565","42000","567218","6209279","49500","547970","176170","114000","12371157","2192000","0","0","14563157","5435487","19998644","POINT (-92.1786426 41.336465)"
"2018_APPANOOSE_REVS_SA","2018","4","APPANOOSE","3994820","0","384181","3610639","0","6000","1070082","4417271","3150","330115","21368","92144","9550769","735590","99283","0","10385642","7075080","17460722","POINT (-92.8686104 40.7431635)"
"2016_TAYLOR_REVS_SA","2016","87","TAYLOR","3720474","3200","274509","3442765","1260","4510","319093","5093439","14731","190525","49467","101235","9217025","797881","0","0","10014906","4167899","14182805","POINT (-94.6964148 40.73743240000001)"
"2016_MUSCATINE_REVS_SA","2016","70","MUSCATINE","15913553","0","715278","15198275","4500","123000","2080982","7255768","64100","1054351","503950","191551","26476477","1654756","4200000","57000","32388233","10803566","43191799","POINT (-91.1127562 41.4839221)"
"2015_KEOKUK_REVS_SA","2015","54","KEOKUK","4715980","130000","140000","4445980","1050","37500","158048","3184124","45000","559415","347845","135000","8913962","1321200","0","0","10235162","4345122","14580284","POINT (-92.1786426 41.336465)"
"2019_GREENE_REVS_SA","2019","37","GREENE","5379355","0","298550","5080805","0","20000","705777","4431834","61625","469000","39547","548393","11356981","1573150","0","0","12930131","4106758","17036889","POINT (-94.3968356 42.0362394)"
"2013_POTTAWATTAMIE_REVS_SA","2013","78","POTTAWATTAMIE","33777818","0","670950","33106868","13300","304500","8160694","28720719","214850","2431975","241806","3354981","76549693","6166387","0","0","82716080","19939240","102655320","POINT (-95.5423935 41.3366123)"
"2012_LOUISA_REVS_SA","2012","58","LOUISA","4850051","2800","139096","4708155","7250","38000","1173514","5437486","11575","602284","34273","56207","12068744","1977081","0","0","14045825","4288719","18334544","POINT (-91.2596184 41.2185073)"
"2022_WAPELLO_REVS_SA","2022","90","WAPELLO","9707678","0","788883","8918795","5462","0","3036914","5063215","68600","679585","220371","486092","18479034","1254000","0","2100","19735134","12167289","31902423","POINT (-92.4094499 41.03058450000001)"
"2021_HUMBOLDT_REVS_SA","2021","46","HUMBOLDT","6073654","0","319993","5753661","788","15575","799339","3308637","10500","337670","42315","90500","10358985","2090185","0","1000","12450170","4653420","17103590","POINT (-94.2071868 42.7764686)"
"2016_KOSSUTH_REVS_SA","2016","55","KOSSUTH","8491686","0","411039","8080647","0","36050","1092286","6121657","16850","606450","169436","143090","16266466","2813273","0","20000","19099739","8542700","27642439","POINT (-94.2067199 43.20413)"
"2012_BUTLER_REVS_SA","2012","12","BUTLER","5613634","0","203400","5410234","0","8000","771562","29958853","13790","583970","456669","220875","37423953","3249000","0","0","40672953","10835865","51508818","POINT (-92.7901934 42.7315661)"
"2014_WASHINGTON_REVS_SA","2014","92","WASHINGTON","8754200","0","354310","8399890","741","70500","3532318","5476983","52550","697977","147184","363250","18741393","2373465","0","0","21114858","7783948","28898806","POINT (-91.7178676 41.335591)"
"2011_CARROLL_REVS_SA","2011","14","CARROLL","6694312","0","225440","6468872","0","20000","1036851","6501318","93800","1671630","229064","783180","16804715","1383740","400000","0","18588455","7832006","26420461","POINT (-94.8605593 42.0362382)"
"2018_CLAY_REVS_SA","2018","21","CLAY","8018937","285","479319","7539333","130","32680","1370984","4758278","14406","594839","279026","544250","15133926","2169279","0","0","17303205","7339976","24643181","POINT (-95.1509194 43.0825804)"
"2020_WASHINGTON_REVS_SA","2020","92","WASHINGTON","12616218","0","768220","11847998","1031","53250","1823125","6321024","81300","774010","355670","1550780","22808188","3575207","6920435","500","33304330","6303872","39608202","POINT (-91.7178676 41.335591)"
"2017_LINN_REVS_SA","2017","57","LINN","63032467","197897","2359665","60474905","30680","680000","8793618","26334897","1220200","6902565","488649","1437477","106362991","21614815","0","41875","128019681","38988225","167007906","POINT (-91.5989646 42.0789478)"
"2016_CRAWFORD_REVS_SA","2016","24","CRAWFORD","7976672","7372","358900","7610400","880","48000","787595","7367567","3500","792334","112816","134097","16857189","2690500","0","226500","19774189","7352146","27126335","POINT (-95.3819678 42.0372125)"
"2015_CLAYTON_REVS_SA","2015","22","CLAYTON","8176582","0","554597","7621985","1327","61500","1375016","5393426","24345","509540","182620","376155","15545914","1600000","0","25000","17170914","6148896","23319810","POINT (-91.34143280000002 42.8447493)"
"2019_JACKSON_REVS_SA","2019","49","JACKSON","6974503","0","400660","6573843","75","3820","947855","5231240","41960","631353","399588","562103","14391837","1167700","0","25","15559562","8017598","23577160","POINT (-90.5742294 42.1717426)"
"2013_HUMBOLDT_REVS_SA","2013","46","HUMBOLDT","4868204","0","166700","4701504","530","7000","505205","2866258","4400","251450","97400","22600","8456347","1494070","0","1500","9951917","2702362","12654279","POINT (-94.2071868 42.7764686)"
"2011_DALLAS_REVS_SA","2011","25","DALLAS","19008930","0","5","19008925","0","210000","631579","8903753","147200","1906835","493488","315024","31616804","6607807","0","0","38224611","18650715","56875326","POINT (-94.0397374 41.6848862)"
"2021_LINN_REVS_SA","2021","57","LINN","77748416","242181","3577020","73929215","25108","569653","8854272","27892805","1278106","8031320","2085542","1396024","124062045","18976961","5000000","22350","148061356","40229989","188291345","POINT (-91.5989646 42.0789478)"
"2020_DES MOINES_REVS_SA","2020","29","DES MOINES","14210713","6620","865600","13338493","8164","130000","2564809","6902246","49885","939510","286882","321738","24541727","2371771","7511143","16000","34440641","12689990","47130631","POINT (-91.1814707 40.9231829)"
"2013_LUCAS_REVS_SA","2013","59","LUCAS","3456781","0","62395","3394386","1310","31100","468207","3820499","450","222154","27020","67286","8032412","582561","100000","500","8715473","1314544","10030017","POINT (-93.3277207 41.0293738)"
"2017_MAHASKA_REVS_SA","2017","62","MAHASKA","7733621","0","334639","7398982","1150","40900","1009259","5392157","28700","607875","215310","716340","15410673","2207679","0","49000","17667352","9183333","26850685","POINT (-92.6409094 41.3352035)"
"2015_LUCAS_REVS_SA","2015","59","LUCAS","3674227","3620","177270","3493337","3560","21300","618144","2569364","450","224720","8020","27600","6966495","604252","200000","500","7771247","1865285","9636532","POINT (-93.3277207 41.0293738)"
"2019_POTTAWATTAMIE_REVS_SA","2019","78","POTTAWATTAMIE","43097695","0","1627500","41470195","5000","315000","8070169","18423354","275800","2354955","71870","3783300","74769643","7998500","0","0","82768143","38586190","121354333","POINT (-95.5423935 41.3366123)"
"2014_MARION_REVS_SA","2014","63","MARION","10896474","0","379439","10517035","500","53000","1316109","5629151","36250","1026826","205966","275800","19060637","2423006","0","1000","21484643","10880514","32365157","POINT (-93.0994367 41.3344515)"
"2021_WAYNE_REVS_SA","2021","93","WAYNE","4454938","0","179469","4275469","0","0","459071","3592104","8038","466504","120285","7278","8928749","784700","0","0","9713449","5586803","15300252","POINT (-93.3273639 40.73947020000001)"
"2018_EMMET_REVS_SA","2018","32","EMMET","4795485","20","257105","4538360","220","12780","393245","3298179","11250","338368","26576","266550","8885528","1075058","0","0","9960586","6391545","16352131","POINT (-94.6784803 43.37802250000001)"
"2018_HOWARD_REVS_SA","2018","45","HOWARD","5304379","0","306317","4998062","1000","11100","2343228","4886481","19000","432807","137781","302059","13131518","1874443","0","0","15005961","6014072","21020033","POINT (-92.3171989 43.3567673)"
"2011_WINNESHIEK_REVS_SA","2011","96","WINNESHIEK","7307401","1300","320419","6985682","650","25650","1387676","7360376","16250","611300","183555","982752","17553891","2061209","0","5000","19620100","4092473","23712573","POINT (-91.8437074 43.2906746)"
"2011_IDA_REVS_SA","2011","47","IDA","2591046","310","85000","2505736","25","4000","403955","2302648","12300","175000","9515","206227","5619406","987228","0","0","6606634","1813595","8420229","POINT (-95.5134962 42.3868747)"
"2020_LYON_REVS_SA","2020","60","LYON","6938808","0","354255","6584553","0","25070","2048982","5919282","76050","958746","297521","263311","16173515","3765567","0","150000","20089082","7802539","27891621","POINT (-96.2102924 43.380497)"
"2017_SIOUX_REVS_SA","2017","84","SIOUX","9960013","0","493050","9466963","650","53000","2036416","7544885","15750","869610","83149","573675","20644098","2981870","0","4500","23630468","8630478","32260946","POINT (-96.1778827 43.0826174)"
"2010_JACKSON_REVS_SA","2010","49","JACKSON","4986624","0","295002","4691622","421","49775","868813","5286422","55521","542305","475025","241670","12211574","1853889","0","2525","14067988","4494333","18562321","POINT (-90.5742294 42.1717426)"
"2015_DUBUQUE_REVS_SA","2015","31","DUBUQUE","29612542","14120","1057100","28541322","14120","229250","4852988","15982385","86200","3983647","227385","225664","54142961","6803299","0","2000","60948260","16992836","77941096","POINT (-90.8824564 42.468832)"
"2017_CLARKE_REVS_SA","2017","20","CLARKE","4544514","2993","232544","4308977","960","45000","317245","2959571","14750","309965","25891","237039","8219398","676992","0","0","8896390","4029342","12925732","POINT (-93.78515790000002 41.0290323)"
"2015_MARION_REVS_SA","2015","63","MARION","10885813","0","757452","10128361","500","53000","1305873","7396418","35800","1028426","201960","88460","20238798","2263389","0","1000","22503187","12233009","34736196","POINT (-93.0994367 41.3344515)"
